wwwwwwwwwwwwwwww
w......w..w...gw
wAw..g.w.......w
w......w.......w
w...w..2.....+.w
w.www2ww.......w
w........w.w...w
w........w.2...w
w.....ww.......w
w......w+......w
www....w.......w
wwwwwwwwwwwwwwww