wwwwwwwwwwwwwwww
ww............gw
wA.............w
w.....www......w
w......w..w....w
w..............w
w...........wwww
w..............w
w.........w.wwww
w....w.........w
w..............w
wwwwwwwwwwwwwwww