wwwwwwwwwwwwwwww
w.....ww.......w
w....gw........w
w.ww.ww........w
w.w.......wwwwww
www..ww.w.wwww.w
w....w..1.w....w
w.2............w
w....w.w..w....w
w.A..w..+......w
w....w.w.......w
wwwwwwwwwwwwwwww