wwwwwwwwwwwwwwww
w......w......gw
wA...g.w.......w
w.....w........w
w.w.w..www...+ww
wwwww2.....ww.ww
www......ww....w
w.2.......w....w
w...2.www......w
w......w+......w
w...w..........w
wwwwwwwwwwwwwwww