wwwwwwwwwwwwwwww
w..............w
w..............w
w..w.ww........w
w..2......wwwwww
w..w......wwwwww
w..w....1.w....w
w..........2...w
w..........2..ww
w.A..w.........w
w..............w
wwwwwwwwwwwwwwww