wwwwwwwwwwwwwwww
ww.............w
www..g.....ww..w
wwwwww.........w
w.w.w.....w..+ww
www........ww..w
ww1..wwww......w
w..............w
w..w.w.ww......w
w....w.ww.....ww
w..............w
wwwwwwwwwwwwwwww