wwwwwwwwwwwwwwww
w.........w.g..w
w....g.........w
w...w.ww.......w
w......w..www..w
w..ww.www......w
w.....w...wwwgww
w..........w...w
w.....ww.......w
w.A1.w.w+.....ww
w......ww......w
wwwwwwwwwwwwwwww