wwwwwwwwwwwwwwww
w.....ww......Aw
w...wwww.......w
w..............w
w.w.w..w..wwwwww
www.w2.....wwwww
w.w..2.w.ww.w..w
w.2............w
w......ww..2...w
w....1.w..w....w
w..............w
wwwwwwwwwwwwwwww