wwwwwwwwwwwwwwww
w......w....g..w
w......w.......w
w..............w
w.w2w..w.w...+ww
www1w2.........w
w....2....w....w
w......w..w....w
w......w...2ww.w
wA.....w+......w
w......w.......w
wwwwwwwwwwwwwwww