wwwwwwwwwwwwwwww
w.....w.......Aw
wA...gw........w
w.ww.ww........w
w.w..........www
www........ww..w
w.w..wwwwwwww..w
w.2......ww....w
w...2wwww......w
w....w.ww.1....w
wwwww..........w
wwwwwwwwwwwwwwww