wwwwwwwwwwwwwwww
w.....ww.ww...gw
w.....w.....w..w
w....w.........w
w...w........+.w
w...........w..w
ww...w....w.ww.w
w..........+...w
w....w....w..w.w
w..............w
w..............w
wwwwwwwwwwwwwwww