wwwwwwwwwwwwwwww
w..g..........Aw
w..g........w..w
w.wwww.........w
w.w.w..1.....+ww
w.w.w.w..w.ww.ww
w.....ww.w.....w
w........w.....w
w.....w....2...w
w.A.....+......w
w..w...........w
wwwwwwwwwwwwwwww