wwwwwwwwwwwwwwww
w.........w.g..w
w..............w
w..w...........w
w...w.....w..+.w
w...w2w........w
w....w....ww.www
w..........w...w
w............www
wA....1.......ww
w......w.......w
wwwwwwwwwwwwwwww