wwwwwwwwwwwwwwww
w..g..w.......Aw
w....gw....gw..w
w.wwwww........w
w.w..........+ww
w.w........www.w
w.1..ww.www....w
w..............w
w....w..w.w....w
w.A..w.........w
w..............w
wwwwwwwwwwwwwwww