wwwwwwwwwwwwwwww
wwwwwww...w....w
w..............w
w..www.........w
w...w........w.w
w..............w
w....wwwwwwwwwww
w.........w+...w
w..w.w....w....w
w....w.........w
w..............w
wwwwwwwwwwwwwwww