wwwwwwwwwwwwwwww
w.........w...gw
w..............w
w.......w......w
w..............w
wwwww2www......w
ww........wwwwww
w.........w+...w
w......w..w..w.w
wA.............w
w......w.......w
www.wwwwwwwwwwww