wwwwwwwwwwwwwwww
w...........g..w
w....g.w.......w
w..w...........w
w.w.w..w.....+.w
w..ww2ww.......w
w..............w
w..............w
w..........2...w
w1.........1...w
w......w.......w
wwwwwwwwwwwwwwww