wwwwwwwwwwwwwwww
w....w.w......gw
www.ww.w.......w
w.w............w
w...w..w..w....w
w...w..........w
w........wwwwwww
w..........+...w
w..............w
w.A..w........ww
w..............w
wwwwwwwwwwwwwwww