wwwwwwwwwwwwwwww
w.............gw
wA.............w
w..ww..........w
w.......w....+ww
w+..w.....www.ww
w..............w
w..........w...w
w...2ww....w.w.w
w....w........ww
w..............w
wwwwwwwwwwwwwwww