wwwwwwwwwwwwwwww
w.....w...w...gw
w....ww....ww..w
w.w.ww.........w
w.w.w.....www+ww
www.w.....wwwwww
w....w.1..w....w
w..............w
w....w.....2...w
w.A..w.........w
w..............w
wwwwwwwwwwwwwwww