wwwwwwwwwwwwwwww
w......w.ww...gw
wAw.ww.w.......w
w.w....w.......w
w.w.w..w.w...+ww
www.w2w....w...w
w.w......w.....w
w........w.2...w
w..........2...w
w...........1..w
w.www..........w
wwwwwwwwwwwwwwww