wwwwwwwwwwwwwwww
w..g..........gw
wA.g...........w
w..wwww........w
w..2.........+.w
w..........ww..w
w....ww.w.wwwwww
w..........+...w
w..............w
w..............w
w..............w
wwwwwwwwwwwwwwww