wwwwwwwwwwwwwwww
w.....w...w...gw
wA...ww........w
w...ww.........w
w.w.w........+1w
www.........w.ww
w.1..w....wwww.w
w..............w
w....w....w..w.w
w....w........ww
w..............w
wwwwwwwwwwwwwwww