wwwwwwwwwwwwwwww
w.........w...gw
w.w..g.........w
w.w....ww......w
w.w.w..wwww..+.w
wwwwwwwww.ww...w
w.........wwww.w
w..........w...w
w......w..w..w.w
w.A.........1..w
w......w.......w
wwwwwwwwwwwwwwww