wwwwwwwwwwwwwwww
w.....ww..w.g..w
w......w.......w
w....ww2.......w
w.w....2.....+.w
w.w..2.........w
w....w....wwww.w
w..........2...w
w..........2...w
w..............w
w..............w
wwwwwwwwwwwwwwww