wwwwwwwwwwwwwwww
w.....g...w...Aw
wA.............w
w..www.........w
w...w........1ww
w..............w
w....www.wwwwwww
w......w.ww....w
w...2www.....w.w
w....w.ww......w
wwwwww.........w
wwwwwwwww.wwwwww