wwwwwwwwwwwwwwww
w........ww.g..w
wA.....w.......w
w..w..ww.......w
w......w..w....w
w..wwwwww......w
w..........wwwww
w.2.1......+...w
w...2..........w
w..............w
w..............w
wwwwwwwwwwwwwwww