wwwwwwwwwwwwwwww
w......w..w...gw
w......w.......w
w.....www......w
w..2...w..ww.+.w
wwwww2.......www
ww...2....wwwwww
w.........w+...w
w.........w..www
wA....2.......ww
w..............w
wwwwwwwwwwwwwwww