wwwwwwwwwwwwwwww
w....www..w....w
w....gww.......w
w.....w........w
w.w.w..w....w+ww
wwwww2ww..w...ww
w......w..w....w
w..............w
w......w..w2...w
w.A..w.w+......w
w..ww..w.......w
wwwwwwwwwwwwwwww