wwwwwwwwwwwwwwww
w......ww.w...gw
wA.............w
w....w.........w
w...w.....w..+.w
w.w.w2....w.w..w
w.........w.w..w
w.........w....w
w..12w....w.wwww
wA...w.w+...1.ww
w..............w
wwwwwwwwwwwwwwww