wwwwwwwwwwwwwwww
w.........w...Aw
wA...g.........w
w.ww...........w
w.w..........+ww
wwwww..........w
w....ww.w.wwwwww
w..........w...w
w..w2wwww......w
w..............w
w..............w
wwwwwwwwwwwwwwww