wwwwwwwwwwwwwwww
w.........w...gw
w..g.g.........w
w.www..........w
w.w.w..1..www+ww
www.w.....ww...w
w.........w....w
w..............w
w......w...2...w
w.A..w.w+.+....w
w......w.......w
wwwwwwwwwwwwwwww