wwwwwwwwwwwwwwww
w.....ww......ww
w....gw........w
w.w.ww.........w
w.w.w......wwwww
w.w.w......ww..w
w.1..wwwwww.w..w
w........ww....w
w..w.w.ww......w
w....w.ww.+....w
wwww...........w
wwwwwwwwwwwwwwww