wwwwwwwwwwwwwwww
w......w.ww...gw
w......w.......w
w..............w
w...w..w.......w
ww..w2.........w
ww.........wwwww
w..........+...w
w.........w..w.w
wA.............w
w..............w
wwwwwwwwwwwwwwww