wwwwwwwwwwwwwwww
w.....w.......Aw
wA...gw.....w..w
w.wwww.........w
w.w.w..2.....+ww
www........ww.ww
w.w..wwwww.....w
w........w.21..w
w....wwww......w
w.......w.1....w
w..............w
wwwwwwwwwwwwwwww