wwwwwwwwwwwwwwww
w..w..w..ww...gw
w....www.......w
w....w.........w
w...w..w.......w
w....www.......w
w.........wwwwww
w..1.......+...w
w.........w..www
wA.............w
w......w.......w
wwwwwwwwwwwwwwww