wwwwwwwwwwwwwwww
w.....ww.......w
w....g.........w
w...w.w........w
w........w...+ww
w...wwwwwwwww.ww
w.....ww.......w
w.........w....w
w.....ww.......w
w.A....w+......w
w..w...w.......w
wwwwwwwwwwwwwwww