wwwwwwwwwwwwwwww
w......w.ww.g..w
wA.....w.......w
w..............w
w...w..w..w..+.w
www1w2w........w
w..........www.w
w..........+...w
w.........w2.www
w.....2.....1..w
w..............w
wwwwwwwwwwwwwwww