wwwwwwwwwwwwwwww
w......w..w...gw
w......w.......w
w......ww......w
w..ww..www.....w
wwwww2w...www..w
w..............w
w..........2...w
w......ww..2...w
wA.....ww...1..w
w..............w
wwwwwwwwwwwwwwww