wwwwwwwwwwwwwwww
w.........w...gw
w..............w
w..w...........w
w...w........+ww
www.w..........w
w....w....wwww.w
w..........+...w
w....w....w....w
w...........1..w
w..............w
wwwwwwwwwwwwwwww