wwwwwwwwwwwwwwww
w....ww...w...gw
w.wg.w.........w
w..............w
w...w........+.w
www1w2.........w
w....ww...wwwwww
w..........+...w
w..w...ww.w....w
w..............w
w..............w
wwwwwwwwwwwwwwww