wwwwwwwwwwwwwwww
w..g.ww.....g.gw
w....ww........w
w.wwww.........w
w.w.w........+ww
www........ww..w
w....www..w.wg.w
w.2.......w.w..w
w....wwww.w.w..w
w.1..w.ww......w
w..w...........w
wwwwwwwwwwwwwwww