wwwwwwwwwwwwwwww
w..............w
wA.............w
w..www.........w
w.........w..+.w
w+........www.ww
w....w.........w
w..............w
w...2ww....w.w.w
w....w.........w
w..............w
wwwwwwwwwwwwwwww