wwwwwwwwwwwwwwww
w.....ww.ww...gw
wA...www.......w
w....w.........w
w...w..w..w....w
w.w.ww.w.......w
w.........wwwwww
w.2............w
w......ww......w
w....w.........w
wwwww..........w
wwwwwwwwwwwwwwww