wwwwwwwwwwwwwwww
w....wwww.w...gw
wA...g.........w
w..wwww........w
w............1.w
w..............w
ww.......wwwwwww
w.........w....w
w....w.ww......w
w....w.w+......w
w....w.w.......w
wwwwwwwwwwwwwwww