wwwwwwwwwwwwwwww
w..............w
w..........1...w
w..w.ww........w
w..2.........+.w
w...........w..w
w....211.......w
w..........2...w
w.........w2ww.w
w..............w
w......w.......w
wwwwwwwwwwwwwwww