wwwwwwwwwwwwwwww
w....ww...w...gw
w....gw........w
w....ww........w
w.w.......wwwwww
wwwww2w.......ww
www.....wwwwwwww
w..............w
w.........w....w
w.A............w
w..............w
wwwwwwwwwwwwwwww