wwwwwwwwwwwwwwww
ww....ww......gw
wA....ww.......w
w...w..2.......w
w.w.w..w.w...+ww
w.w.w.w..w.ww.ww
w.....w..w.....w
w........w.2...w
w..........2...w
w...........1..w
w..............w
wwwwwwwwwwwwwwww