wwwwwwwwwwwwwwww
ww.............w
ww...g.........w
w..w...........w
w............+.w
w...w......w...w
w....ww.1......w
w..........2...w
w.....ww...w.w.w
w....www+....www
w......w.......w
wwwwwwwwwwwwwwww