wwwwwwwwwwwwwwww
ww....ww..w....w
w....gw........w
w...www........w
ww........w.wwww
w....ww....www.w
w....wwwwwwwwwww
w.........w+...w
w..w...........w
w..............w
w..............w
wwwwwwwwwwwwwwww