wwwwwwwwwwwwwwww
w....w....w.g..w
w..............w
w..w.w.........w
w..2......w..www
w.www......w...w
w....w..1.wwwgww
w.........w....w
w....w.........w
w.A..w........ww
w....w.w.......w
wwwwwwwwwwwwwwww