wwwwwwwwwwwwwwww
w.............gw
w....g.........w
w.w....ww......w
w.w....ww....+.w
w...wwwww......w
w.....w.ww.www.w
w.....w....w...w
w.....w....w....
w..............w
w..............w
wwwwwwwwwwwwwwww