wwwwwwwwwwwwwwww
w.....ww.......w
w....gw........w
w.w..ww........w
w.w..........www
www.wwwwwwwwwwww
w.........w....w
w.2............w
w....wwww......w
w.A............w
w..w...w.......w
wwwwwwwwwwwwwwww