wwwwwwwwwwwwwwww
w.........w...gw
w..............w
w..............w
w......w.....1.w
w....wwww......w
w..........www.w
w..........+...w
w.........w....w
wA.............w
w......w.......w
wwwwwwwwwwwwwwww