wwwwwwwwwwwwwwww
ww.....w.ww...gw
wA.....w.......w
w......ww......w
w......ww....1.w
w.....ww.......w
w.....w..w.....w
w........w.2...w
w.....w....2.www
w1.........1...w
w..............w
wwwwwwwwwwwwwwww