wwwwwwwwwwwwwwww
w.........w...gw
w..............w
w.....www......w
w..ww..ww.w.w+ww
wwwww.ww.....www
w...........wg.w
w..........2...w
w.........w2..ww
w.A............w
w..ww..........w
wwwwwwwwwwwwwwww