wwwwwwwwwwwwwwww
w....www..w.g..w
w....www.......w
w......w.......w
w.w.w..w..w.w+.w
www1w2ww.......w
w.....wwww.wwwww
w..........+...w
w..............w
wA..........1..w
w..............w
wwwwwwwwwwwwwwww