wwwwwwwwwwwwwwww
w.............gw
w....www.......w
w..............w
w.w.w..w.....+.w
www1w.www.....ww
w.1........www.w
w.........w+...w
w.........w..w.w
w.A............w
w......w.......w
wwwwwwwwwwwwwwww