wwwwwwwwwwwwwwww
w....w....w...gw
w..............w
w..www.........w
w..2......www+ww
w..ww.....www.ww
w.........w....w
w..........2...w
w......w...2wwww
wA...w.w+......w
w....w.w.......w
wwwwwwwwwwwwwwww