wwwwwwwwwwwwwwww
w.....ww.ww....w
w....www.......w
w......ww......w
w.w.w..2..w..+.w
w...wwwww......w
w.........wwwwww
w..........+...w
w......ww.w..w.w
w......w+...1..w
w......w.......w
wwwwwwwwwwwwwwww