wwwwwwwwwwwwwwww
w..1..........gw
w..............w
w..w..w.w......w
w............+.w
w...w2........ww
w..............w
w..........+...w
w.........ww.w.w
wA....1........w
w..............w
www..wwwwwwwwwww