wwwwwwwwwwwwwwww
w.........w....w
w....g.........w
w..www.........w
w.........w..+ww
w...w2....w....w
w.........w....w
w..............w
w......w...2...w
wA.....w+...1..w
w......w.......w
wwwwwwwwwwwwwwww