wwwwwwwwwwwwwwww
w.........w....w
wA.............w
w....w.........w
w.w.w........+.w
www1w.w........w
ww........wwww.w
w.........w....w
w..........2...w
wA...w2.....1..w
w..............w
wwwwwwwwwwwwwwww