wwwwwwwwwwwwwwww
w.....w........w
w....ww........w
w.w............w
w.w.w........+.w
www.wwww.ww.w..w
ww...ww........w
w..............w
w....w....w..w.w
w.A..w..w...1.ww
w..............w
wwwwwwwwwwwwwwww