wwwwwwwwwwwwwwww
w.............gw
wA..........w..w
w..w..w.w......w
w..2....ww...+ww
wwwww2.wwwwwwwww
w..............w
w.2............w
w...2w.w...2...w
w....w.w+......w
w..wwwww.......w
wwwwwwwwwwwwwwww