wwwwwwwwwwwwwwww
www...........gw
www............w
w..............w
w......w.....1.w
w.....ww.......w
w....ww.w......w
w..........w...w
w.....w.w....w.w
w.......w......w
w..............w
wwwwwwwwwwwwwwww