wwwwwwwwwwwwwwww
w.............gw
wA.............w
w..ww..........w
w...w.....w....w
w...w2....www..w
w....2....w....w
w.........w....w
w......w.....www
w....www+.....ww
w....w.w.......w
wwwwwwwwwwwwwwww