wwwwwwwwwwwwwwww
w......w..w...gw
wA...w.w.......w
w..www.........w
w...w..w.....+.w
w..............w
w........w.wwwww
w........w.w...w
w..............w
w1..........1..w
w..............w
wwwwwwwwwwwwwwww