wwwwwwwwwwwwwwww
w.....ww..w...Aw
wA.g..ww.......w
w....ww........w
w.w.w..2.....+ww
www.w.www.....ww
www......w.wwgww
w..............w
w...2w......w..w
w.A............w
w..ww..........w
wwwwwwwwwwwwwwww