wwwwwwwwwwwwwwww
w.....ww..w...gw
wA...ww........w
w....w.........w
w...w........1.w
w+w.www........w
w...........w..w
w..............w
w....w.ww.w.wwww
w......w+......w
www....w.......w
wwwwwwwwwwwwwwww