wwwwwwwwwwwwwwww
w......w......gw
wAwg...w.......w
w...w..........w
w...w..w.....+.w
w.w.w.w.....w..w
w........w.....w
w........w.2...w
w...2ww.w..2...w
w..............w
w..w...........w
wwwwwwwwwwwwwwww