wwwwwwwwwwwwwwww
w.............gw
wwwg...........w
w..............w
w.w..........+ww
www.w.w...www..w
w....ww.1.w....w
w..............w
w....ww.w..w.w.w
w.A..w..w.....ww
w..w...........w
wwwwwwwwwwwwwwww