wwwwwwwwwwwwwwww
w..wwwww......Aw
w.....w........w
w...www........w
w...w..1..www+ww
w.........wwwwww
w........ww.wg.w
w..............w
w......ww......w
w.A..w.........w
w..............w
wwwwwwwwwwwwwwww