wwwwwwwwwwwwwwww
w.........w...gw
w..............w
w......w.......w
w.w2...w.wwww..w
www1w2.........w
w........wwwwgww
w.2........+...w
w.............ww
w..............w
w..............w
wwwwwwwwwwwwwwww