wwwwwwwwwwwwwwww
ww............gw
ww...g.........w
w.ww...........w
w.w..........+.w
w.....w...www..w
w....ww........w
w..........w...w
w..w.ww.w..w.w.w
wA.1..........ww
w..............w
wwwwwwwwwwwwwwww