wwwwwwwwwwwwwwww
w....w....w....w
wA..........w..w
w...www........w
w...w........+.w
w...........w..w
ww...w....w.w..w
w..............w
w....w.ww.w2wwww
w2...w.ww......w
w..............w
wwwwwwwwwwwwwwww