wwwwwwwwwwwwwwww
w.........w...gw
wA.............w
w..............w
w.w.w.....w..+.w
w.w.w2....ww...w
w.........wwww.w
w..........w...w
w....w.......w.w
w.............ww
w..............w
wwwwwwwwwwwwwwww