wwwwwwwwwwwwwwww
w....w.w..w...gw
wA..ww.w.......w
w...w..........w
w.w.w.....w..1.w
www.w2.........w
ww1..2...wwwwwww
w..............w
w...2..........w
w....w......1..w
w..w...........w
wwwwwwwwwwwwwwww