wwwwwwwwwwwwwwww
w......w.......w
w...........w..w
w..w.w.........w
w...w.....w..+.w
w...w2....www..w
w.........w....w
w..........2...w
w....w.w...2...w
wA...w..+......w
w..............w
wwwwwwwwwwwwwwww