wwwwwwwwwwwwwwww
w.........w...gw
w..............w
w......ww......w
w.w2w..wwww..+.w
www.w2.ww.w....w
w.........wwwg.w
w.2........+...w
w.........w2..ww
w.A..w........ww
w..............w
wwwwwwwwwwwwwwww