wwwwwwwwwwwwwwww
w.....ww..w....w
w....g.........w
w..w.w.........w
w.........w.wwww
w....2.....ww.ww
w....wwww.w....w
w.........w+...w
w....w.w..w....w
wA.............w
w......w.......w
wwwwwwwwwwwwwwww