wwwwwwwwwwwwwwww
w..w.w........gw
w..............w
w..w.w.........w
w.wwww.......+.w
wwwww2....www..w
w.w.......w.ww.w
w.........w....w
w....w....w.ww.w
w.A..w.........w
w......w.......w
wwwwwwwwwwwwwwww