wwwwwwwwwwwwwwww
w.....w........w
wA...g.........w
w..w...........w
w.w2w..w..w..www
www.w2.w.....www
w.w..2.w..wwwwww
w.2........2...w
w......w.......w
w.A............w
w......w.......w
wwwwwwwwwwwwwwww