wwwwwwwwwwwwwwww
w..g...........w
w..............w
w..wwww........w
w..2.........+ww
w.............ww
w....ww.w..w.www
w..1.......+...w
w............www
wA.............w
w..............w
wwwwwwwwwwwwwwww