wwwwwwwwwwwwwwww
w.....ww.w..g..w
w.....ww.......w
w....w.........w
w...w..w.......w
w.........w.w..w
w..............w
w..1.......2...w
w..........2...w
wA.............w
w..............w
wwwwwwwwwwwwwwww