wwwwwwwwwwwwwwww
w....ww........w
w....g......w..w
w...ww.........w
w...w.....wwwwww
w...w2...wwwwwww
ww...w....w....w
w..........+...w
w....w.w.......w
w..............w
w..............w
wwwwwwwwwwwwwwww