wwwwwwwwwwwwwwww
w..1......w.g..w
wA....ww.......w
w....wwww......w
w......www...+ww
w....wwwww.wwwww
w..............w
w..........2...w
w.....w....2...w
w..............w
ww.............w
wwwwwwwwwwwwwwww