wwwwwwwwwwwwwwww
w..g..ww......Aw
w....ww........w
w...www.w......w
w.w.w.....wwwwww
www..2....wwww.w
www..2....w.ww.w
w.2.......w....w
w....w.ww.w....w
w....w.w.......w
w..............w
wwwwwwwwwwwwwwww