wwwwwwwwwwwwwwww
w.............gw
w....g.........w
w..............w
w............1.w
w..............w
w....wwww.wwwwww
w.........ww...w
w....w.w..w....w
wA.............w
w..............w
wwwwwwwwwwwwwwww