wwwwwwwwwwwwwwww
w..............w
w..............w
w..............w
w.w2......w..w.w
w..ww2www..w...w
w..............w
w.........w+...w
w......w..ww.w.w
wA.....w+.....ww
w......ww......w
wwwwwwwwwwwwwwww