wwwwwwwwwwwwwwww
w.............gw
w..............w
w..w..w........w
w..2....www..www
wwwww2....wwww.w
w....2....ww.www
w.2.2......+...w
w...2.....w..www
w..............w
w..............w
wwwwwwwwwwwwwwww