wwwwwwwwwwwwwwww
w......w..w...gw
w....www.......w
w..............w
w.w.w..w.....+.w
www.wwww.......w
ww....w....wwwww
w..........1...w
w......ww.w..w.w
w...........1..w
w..............w
wwwwwwwwwwwwwwww