wwwwwwwwwwwwwwww
w.........w....w
w..............w
w.....w.w......w
ww..w...w....+.w
www.w.www......w
ww........wwwgww
w..1......w....w
w......w..w..w.w
wA.............w
w......ww......w
wwwwwwwwwwwwwwww