wwwwwwwwwwwwwwww
w.....ww..w....w
w....gww.......w
w...w.www......w
www....w.wwww+ww
wwwww2w....ww.ww
ww....w.ww.....w
w........w.2...w
w......w...2...w
w.A.........1..w
w......w.......w
wwwwwwwwwwwwwwww