wwwwwwwwwwwwwwww
w.........w...gw
wA.............w
w.....www......w
ww.ww...www..+ww
wwwww2....ww...w
ww........wwwwww
w..........+...w
w....w....w....w
w.A..w.........w
w....w.........w
wwwwwwwwwwwwwwww