wwwwwwwwwwwwwwww
wwgw..ww.......w
w....ww........w
w...ww.........w
w.w.w..1..w..1.w
w..............w
w....w..www.ww.w
w..........2...w
w..............w
w.A..w.........w
w..............w
wwwwwwwwwwwwwwww