wwwwwwwwwwwwwwww
w.........w.1..w
w....g.........w
w..www.........w
w..2........wwww
w..............w
w....ww1wwwwwwww
w..........+...w
w....w.........w
w.A..ww........w
w..............w
wwwwwwwwwwwwwwww