wwwwwwwwwwwwwwww
w..............w
wA.............w
w..w.ww.w......w
w..2.........+ww
w..ww2....wwwwww
w..............w
w..........2...w
w....ww....2.www
w....w........ww
w..........w...w
wwwwwwwwwwwwwwww