wwwwwwwwwwwwwwww
w.....wwwww...gw
wA.g...........w
w..wwww........w
wA.2......w.w..w
w.........www..w
w....ww1w......w
w..........2...w
w..w.w..w..w.www
w....ww.w.....ww
w..............w
wwwwwwwwwwwwwwww