wwwwwwwwwwwwwwww
w......w..w...gw
wA.g...........w
w...www.w......w
w...w...w....+.w
www.w.....wwww.w
w.........wwwwww
w..............w
w...2w....w.wwww
w....w.........w
w..www.........w
wwwwwwwwwwwwwwww