wwwwwwwwwwwwwwww
w..............w
w....w.....ww..w
w..............w
w...w..w.w...+ww
w.w1wwww.wwww.ww
w..............w
w........w.2...w
w......w...2...w
wA.....w....1..w
w......w.......w
wwwwwwwwwwwwwwww