wwwwwwwwwwwwwwww
w....ww........w
w....w.w.......w
w..............w
w.w.w..w.....+.w
w.w.w2.........w
ww...2.....wwwww
w.2.......w....w
w......w..w....w
w.A....w.......w
w......w.......w
wwwwwwwwwwwwwwww