wwwwwwwwwwwwwwww
w..w.www..w...gw
w....ww....1...w
w....ww........w
w...w........1.w
w.....w........w
ww...www.wwwwwww
w.........w....w
w......w..w....w
w..............w
w......w.......w
wwwwwwwwwwwwwwww