wwwwwwwwwwwwwwww
w.....ww.......w
w....gw........w
w...w.w........w
w...w.....wwwwww
w...w2w...wwwwww
w......w.ww....w
w..............w
w......ww......w
wA.....w..+....w
w......w.......w
wwwwwwwwwwwwwwww