wwwwwwwwwwwwwwww
w......w..w...gw
w..............w
w..w..ww.......w
w........ww....w
w..ww2.....w...w
w.......2.ww.w.w
w..........2...w
w............www
w.....2.......ww
w..............w
wwwwwwwwwwwwwwww