wwwwwwwwwwwwwwww
w......w.ww...gw
w....g.w.......w
w...w..2.......w
w...w..w..w....w
w....2.........w
ww.......wwwwwww
w..........+...w
w......ww......w
wA.....ww...1..w
w..............w
wwwwwwwwwwwwwwww