wwwwwwwwwwwwwwww
w......w..w....w
w..........1w..w
w....ww........w
w.w.w........+.w
www.w......ww..w
w.1..wwwww.www.w
w..........ww..w
w....w..w.w2...w
w...........1..w
w..............w
wwwwwwwwwwwwwwww