wwwwwwwwwwwwwwww
w.........w.g.gw
w..............w
w..w...........w
w..2...1..w....w
w..ww2.........w
w....2....wwwwww
w..........+....
w.........w..www
wA...w2.......ww
w..............w
wwwwwwwwwwwwwwww