wwwwwwwwwwwwwwww
w.........w....w
wA...g.........w
w..ww..........w
w..ww........+ww
ww..w......wwwww
ww...wwwww.....w
w..............w
w...2ww....2...w
w..............w
w..w...........w
wwwwwwwwwwwwwwww