wwwwwwwwwwwwwwww
w.............gw
ww.............w
w.......w......w
w.......ww...+.w
wwwwwwwwwwwww..w
w..............w
w..........+...w
w.....w........w
w.A............w
w..............w
wwwwwwwwwwwwwwww