wwwwwwwwwwwwwwww
w......w..w...gw
w....gw........w
w..w...........w
w..............w
w...wwww.......w
w....ww.1..www.w
w..........+...w
w...2..w.......w
w.A....w.......w
w......w.......w
wwwwwwwwwwwwwwww