wwwwwwwwwwwwwwww
w......w..w...gw
wA.............w
w..w..w........w
w..2...........w
wwwww2.........w
w....2....wwwwww
w.........w....w
w...2w.w..w..www
w....w........ww
w..............w
wwwwwwwwwwwwwwww