wwwwwwwwwwwwwwww
w.........w.g..w
wAw............w
w.w............w
w.w.w..w..w..+.w
w..1w.w........w
w....ww.1......w
w..........2...w
w..........2.www
w.....2.....1..w
w..............w
wwwwwwwwwwwwwwww