wwwwwwwwwwwwwwww
w..g..ww.......w
w....g......1..w
w....ww........w
w............+.w
w...........w..w
ww....w.ww.....w
w..........2...w
w......ww..2...w
wA.....ww......w
w..............w
wwwwwwwwwwwwwwww