wwwwwwwwwwwwwwww
w...........1.gw
wA.............w
w..wwww2.......w
w......1.....+.w
w...w....1.ww..w
w..............w
w..............w
w.....www......w
w....w.w+......w
w......w.......w
wwwwwwwwwwwwwwww