wwwwwwwwwwwwwwww
w.gg.w....w...gw
w..............w
w..ww..........w
w.w2w..1..w..1.w
www.w..........w
w....2.1..wwwwww
w..........+...w
w.........w..w.w
w..............w
w..............w
wwwwwwwwwwwwwwww