wwwwwwwwwwwwwwww
w..g..........gw
w..............w
w..............w
w.w2w..w.w...+ww
w.w......wwwwwww
w..............w
w........w.....w
w.....w.w..2...w
wA...w..w......w
w..........w...w
wwwwwwwwwwwwwwww