wwwwwwwwwwwwwwww
w.gg...........w
w......w.......w
w..............w
w..2w..w.w...+.w
w...w..w.wwww.ww
w..............w
w..1.......2...w
w..........2...w
wA.............w
w..............w
wwwwwwwwwwwwwwww