wwwwwwwwwwwwwwww
w.........w....w
wA.............w
w..............w
w.w.w..1.......w
w.....w........w
w....ww.1......w
w..........2...w
w..........2.w.w
w1....2.w......w
w..............w
wwwwww.wwwwwwwww