wwwwwwwwwwwwwwww
w.........w.w.gw
w..............w
w.....www......w
w..2...www.ww+ww
w..ww.wwwww...ww
w............g.w
w..............w
w......w...2wwww
wA.....w..w....w
w......w.......w
wwwwwwwwwwwwwwww