wwwwwwwwwwwwwwww
w.........w...gw
wA.............w
w..w...........w
w.w.w..........w
www............w
www..2w...wwwwww
w.........ww...w
w...2.....w....w
w.............ww
w..............w
wwwwwwwwwwwwwwww