wwwwwwwwwwwwwwww
w.........w...gw
w..g.g.........w
w..............w
w...w.....w..+.w
www.www........w
ww........wwwgww
w..........w...w
w......ww.w....w
wA.............w
w..............w
wwwwwwwwwwwwwwww