wwwwwwwwwwwwwwww
w..g..w...w....w
w....ww........w
w.ww.ww........w
w.w....w..w.wwww
w..............w
w....ww.wwwwwwww
w..........2...w
w..............w
wA.............w
w..............w
wwwwwwwwwwwwwwww