wwwwwwwwwwwwwwww
w.............gw
wA.............w
w..w...........w
w.........w....w
w.w..2.........w
w....w....wwwwww
w..........w...w
w..w....w......w
wA....2.......ww
w..............w
wwwwwwwwwwwwwwww