wwwwwwwwwwwwwwww
w..............w
w..............w
w..............w
w.www..2.....+.w
www1w.w........w
ww1..ww.w.ww.w.w
w..........w...w
w..........w....
w...........1.ww
w..............w
wwwwwwwwwwwwwwww