wwwwwwwwwwwwwwww
w.....ww..w.g..w
wA...gw........w
w...www2.......w
w...w..2..w..+ww
www.w2....ww...w
ww...2..1.wwwwww
w..........2...w
w..w.w.ww......w
w....w..+.....ww
w..............w
wwwwwwwwwwwwwwww