wwwwwwwwwwwwwwww
w.............gw
wA.....w.......w
w..............w
w.w.w..w.......w
www.w.ww....w..w
w..........www.w
w.2............w
w.........ww.w.w
w.............ww
w..............w
wwwwwwwwwwwwwwww