wwwwwwwwwwwwwwww
w.........w....w
w..............w
w..w...........w
w.w.w........+.w
w.w..ww........w
w....w..1......w
w..........w...w
w....w....ww.w.w
wA...w2.......ww
w......w.......w
wwwwwwwwwwwwwwww