wwwwwwwwwwwwwwww
w...........g..w
w....g.........w
w..ww..........w
w.w2...1.......w
w.www......ww..w
w.....wwww.w..ww
w........w.2...w
w.....www..2...w
w......ww.1....w
w..............w
wwwwwwwwwwwwwwww