wwwwwwwwwwwwwwww
w..............w
wA...g.........w
w..w...........w
w......1.ww..+ww
ww.ww2wwwwwww.ww
ww.............w
w........w.2...w
w.....www..2...w
w.......+......w
w..............w
wwwwwwwwwwwwwwww