wwwwwwwwwwwwwwww
w....w.w..w...gw
wA.....w.......w
w..............w
w.w.w..w..w....w
www.w2w........w
w.w.......wwwwww
w.2............w
w.........w....w
w.A............w
w..ww..........w
wwwwwwwwwwwwwwww