wwwwwwwwwwwwwwww
w...........1..w
w..............w
w..w.ww........w
w..2......w..w.w
w.ww.2....wwww.w
w....2....w..www
w.........w....w
w...2w....w..www
w1...w.ww.....ww
w....w.........w
wwwwwwwwwwwwwwww