wwwwwwwwwwwwwwww
w....www..w....w
w....gww.......w
w.....w........w
w......w.wwww+ww
wwwwwwwwwwwwwwww
ww.............w
w..............w
w......w...2...w
w.A....w.......w
w......ww......w
wwwwwwwwwwwwwwww