wwwwwwwwwwwwwwww
w.............gw
w..............w
w..w..w.w......w
w.......w....+.w
w....wwww.w.w..w
w..............w
w..........+...w
w......ww.ww.www
w.A...........ww
w......w.......w
wwwwwwwwwwwwwwww