wwwwwwwwwwwwwwww
w.........w.g..w
w....gw........w
w.....ww.......w
w.w2...ww.w....w
wwwww.www..w...w
www...w........w
w.2........2...w
w.....www.w2w..w
w.A....w+......w
w......w.......w
wwwwwwwwwwwwwwww