wwwwwwwwwwwwwwww
w......w......gw
wA...g.w.......w
w..w.ww........w
w......w..w..www
w....2.........w
w........wwwwwww
w........ww+...w
w..............w
w..............w
w..............w
wwwwwwwwwwwwwwww