wwwwwwwwwwwwwwww
w.....ww......Aw
w..g.g.........w
w.....w........w
w...w........+ww
wwwww2w...www.ww
ww1.....w......w
w..........2...w
w.....www.w2...w
w.......w.1....w
w..............w
wwwwwwwwwwwwwwww