wwwwwwwwwwwwwwww
w.............gw
w..............w
w..w..www......w
w..2...wwwww.www
wwwww2.wwwwwwwww
w....2....ww.www
w.2........+...w
w...2......w.www
w...1..........w
w..............w
wwwwwwwwwwwwwwww