wwwwwwwwwwwwwwww
w.....ww.......w
w....gw........w
w....ww........w
w............+ww
www.wwwww......w
w.....w.w....w.w
w.........w....w
w...w..w..w....w
w.A............w
w..w...w.......w
wwwwwwwwwwwwwwww