wwwwwwwwwwwwwwww
ww....ww..w....w
ww...gw........w
w....ww2.......w
w.........2..+ww
w..........w...w
w....ww.w.wwww.w
w.........ww...w
w....wwww......w
w.A..w..+......w
w......w.......w
wwwwwwwwwwwwwwww