wwwwwwwwwwwwwwww
w.............gw
wA.....w.......w
w..............w
w...w..w.ww....w
w...wwww.......w
w..........w...w
w..........+...w
w.............ww
wA.............w
w..............w
wwwwwwwwwwwwwwww