wwwwwwwwwwwwwwww
w.........w...gw
w..............w
w..w..w.w......w
w..2.........1.w
w..ww2.........w
w.......1..wwwww
w..........w...w
w.........ww.w.w
wA....1.......ww
w..............w
wwwwwwwwwwwwwwww