wwwwwwwwwwwwwwww
w......w.......w
wA.............w
w..............w
w..2.....ww....w
wwwww2....wwwwww
w.w............w
w.2........2...w
w..........2...w
w.......2......w
w..............w
wwwwwwwwwwwwwwww