wwwwwwwwwwwwwwww
w....www.ww.g..w
w....www.......w
w....w.........w
w.w.w..w..w..+.w
w.w...ww.......w
ww1.......wwwwww
w..1...........w
w.........w.ww.w
wA.............w
w......w.......w
wwwwwwwwwwwwwwww