wwwwwwwwwwwwwwww
w..1..........Aw
w..............w
w..............w
w.w.w........+.w
www.w2w.....w..w
w....ww.w..www.w
w.........w+...w
w.........w.w..w
wA.............w
w..............w
wwwwwwwwwwwwwwww