wwwwwwwwwwwwwwww
w..g..ww..w...Aw
w.....ww.......w
w...www........w
w...w........+ww
www.........w.ww
ww1......wwwwwww
w.........w....w
w...2.....w.w..w
w..............w
w..............w
wwwwwwwwwwwwwwww