wwwwwwwwwwwwwwww
w.........w...gw
w....g.........w
w......ww......w
w.w2w..wwwwwwwww
wwwww2....w..www
w.w......wwwwwww
w..........+...w
w.............ww
w.A.........1..w
w..............w
wwwwwwwwwwwwwwww