wwwwwwwwwwwwwwww
w..g..ww.......w
w....gww....1..w
w....ww........w
w......w.....1.w
w..............w
w.....w.wwwwwwww
w.........w+...w
w.......w.w....w
w1......w......w
w..............w
wwwwwwwwwwwwwwww