wwwwwwwwwwwwwwww
w..g...........w
w..............w
w..w.ww.w......w
w..2.........+.w
w.www2.ww.w..w.w
www............w
w.2.......w....w
w.....www.w....w
w.A..w.w+......w
w......w.......w
wwwwwwwwwwwwwwww