wwwwwwwwwwwwwwww
w......w..w...gw
wA.............w
w..............w
w...w..........w
www.w..........w
ww...ww.ww.wwwww
w.........ww...w
w.........w....w
w.............ww
w..............w
wwwwwwwwwwwwwwww