wwwwwwwwwwwwwwww
w......w......gw
w.....ww.......w
w.....w........w
w.w2w..w.....www
wwwww2www.....ww
www........wwwww
w.2.......w....w
w......w..w....w
w......w.......w
w...w..w.......w
wwwwwwwwwwwwwwww