wwwwwwwwwwwwwwww
w........ww...gw
w..............w
w.......w......w
w...w..w.....+.w
w.....ww.......w
ww........wwwwww
w..........+...w
w.......w.w..w.w
wA..........1..w
w..............w
wwwwwwwwwwwwwwww