wwwwwwwwwwwwwwww
w.....ww......gw
wAw.www........w
w....w.........w
w.w.w........+ww
w.w.w.......w..w
w.....w..w..ww.w
w..............w
w....w.ww.w..w.w
w.......w......w
www............w
wwwwwwwwwwwwwwww