wwwwwwwwwwwwwwww
w....www.......w
w....g.........w
w..w.ww........w
ww.2......w.wwww
wwwww.....wwwwww
w....ww.1......w
w..........2...w
w....w.....2...w
w.A..w.........w
w..w...........w
wwwwwwwwwwwwwwww