wwwwwwwwwwwwwwww
w.....ww.......w
w....gw........w
w.....w2w......w
w.w.w..2.....+ww
www.w.wwww....ww
ww1...w........w
w..1.......2...w
w.....wwww.2...w
wA......w...1..w
w..............w
wwwwwwwwwwwwwwww