wwwwwwwwwwwwwwww
w.............Aw
wA.............w
w.....www......w
w.ww...www.ww+ww
wwwww.wwwwwww.ww
www............w
w..............w
w.....www.ww.www
w......w.......w
w..............w
wwwwwwwwwwwwwwww