wwwwwwwwwwwwwwww
w....ww...w...gw
w..............w
w...w..........w
w...w.....w..+.w
www.w.....wwww.w
ww...w....w.ww.w
w..............w
w....w....w.wwww
wA...w........ww
w..............w
wwwwwwwwwwwwwwww