wwwwwwwwwwwwwwww
ww.....w..w....w
w....g.........w
ww..w.www......w
ww......wwwwwwww
w...w2w.w......w
ww........wwwwww
w..........2...w
w..............w
w.A............w
w..............w
wwwwwwwwwwwwwwww