wwwwwwwwwwwwwwww
w..g..........Aw
w....g.....1...w
w....ww.w......w
w..2w........+ww
www..2..w...w.ww
www..2....wwwwww
w.........w....w
w......w..w....w
wA..........1..w
w......w.......w
wwwwwwwwwwwwwwww