wwwwwwwwwwwwwwww
w.....w.......Aw
w....gw........w
w..w.ww........w
w..2......wwwwww
wwwww2...wwwwwww
w....2....w....w
w.2........+...w
w...ww....w....w
w.A............w
w..............w
wwwwwwwwwwwwwwww