wwwwwwwwwwwwwwww
w.....w.......gw
wA...ww........w
w..w.ww........w
w............+ww
www.w2....wwwwww
w.w.......w.w..w
w.........w....w
w...2w.w..w....w
w....w.w.......w
w..www.w.......w
wwwwwwwwwwwwwwww