wwwwwwwwwwwwwwww
w.........w...gw
w..............w
w..............w
w.w.w..w..w..w.w
www.w2.....www.w
www.......ww1g.w
w..............w
w......ww..2...w
wA..........1..w
w..............w
wwwwwwwwwwwwwwww