wwwwwwwwwwwwwwww
w.............gw
w....w.w.......w
w..............w
w.w.w..w.w...+.w
www.w2.w.......w
w....2.....www.w
w.2........+...w
w.........w....w
w...........1..w
w..............w
wwwwwwwwwwwwwwww