wwwwwwwwwwwwwwww
w.............gw
wA.............w
w..w...........w
w...w....ww..+ww
wwwww2...wwwwwww
w..............w
w.2........+...w
w......w.....www
w..............w
w..............w
wwwwwwwwwwwwwwww