wwwwwwwwwwwwwwww
w..w.ww.......gw
w....ww....11..w
w..1.w.........w
w.w.w........+.w
w.w.........w..w
w.1..1....wwwwww
w.........w....w
w.......w.w..w.w
w.A..w.w.......w
w......w.......w
wwwwwwwwwwwwwwww