wwwwwwwwwwwwwwww
w.........w...gw
wA.............w
w.....w.w......w
w...w..ww....+.w
w...wwwww.....ww
w..........wwwww
w..........+...w
w......ww....www
wA..........1..w
w..............w
wwwwwwwwwwwwwwww