wwwwwwwwwwwwwwww
w..............w
w....gw........w
w.....w........w
w.w2w....ww..+.w
w.www2www.w....w
w....2....w..w.w
w.........w+...w
w......ww.w2.w.w
w......w+......w
w......ww......w
wwwwwwwwwwwwwwww