wwwwwwwwwwwwwwww
w.........w...gw
wA........w....w
w.....w.w......w
w.w.w..ww.w..+ww
w..wwwwww......w
w.......wwwwwwww
w.........w+...w
w..............w
w...........1..w
w..............w
wwwwwwwwwwwwwwww