wwwwwwwwwwwwwwww
ww....www.w....w
wA..........1..w
ww.wwww........w
w............+.w
w..............w
w....ww.1.wwwwww
w.........w....w
w..w.w.w.......w
w....w.w+.....ww
w......w.......w
wwwwwwwwwwwwwwww