wwwwwwwwwwwwwwww
w..............w
w..............w
w.....www......w
w......www...+ww
ww.wwwwwwwww..ww
ww.............w
w.2........+...w
w......w.......w
w.A............w
w......w.......w
wwwwwwwwwwwwwwww