wwwwwwwwwwwwwwww
w.....ww.w....gw
w...wgww.......w
w......w.......w
w.w.w..w.wwwwwww
wwwww2ww.wwwwwww
w.........w....w
w.2........2...w
w......ww......w
w......w+......w
w......w.......w
wwwwwwwwwwwwwwww