wwwwwwwwwwwwwwww
w.........w....w
www............w
ww.w.w.........w
w.........w..+.w
w..www....ww...w
w..w.w..w.w..w.w
w..........+...w
w......w.....w.w
w.A..w..+.....ww
w......w.......w
wwwwwwwwwwwwwwww