wwwwwwwwwwwwwwww
w.........w...gw
wA.............w
w..w.w.........w
w.......1.1....w
w..2...........w
w....w..w.wwwwww
w..........w...w
w...2......w.w.w
w...1w........ww
w..............w
wwwwwwwwwwwwwwww