wwwwwwwwwwwwwwww
w....www.......w
w....g.........w
w....w.........w
w...w........+.w
ww...2.........w
ww...wwww.wwww.w
w..........+...w
w.........w....w
wA.............w
w..............w
wwwwwwwwwwwwwwww