wwwwwwwwwwwwwwww
w..g......w...gw
wA....w........w
w.....www......w
w.w.w..w.....1.w
www.w.www......w
www........wwwww
w..............w
w.....www.w..www
w..............w
w..............w
wwwwwwwwwwwwwwww