wwwwwwwwwwwwwwww
w.........w.g..w
w..............w
w.....www......w
w..2...w..w..+.w
w..............w
w.....w...wwwgww
w..1...........w
w............www
wA............ww
w..............w
wwwwwwwwwwwwwwww