wwwwwwwwwwwwwwww
ww....ww....g..w
w....g.........w
w...w..........w
w...w..w.wwwww.w
w...wwww...w...w
w.....wwww.....w
w..1.......2...w
w.....w....2...w
wA.............w
w..............w
wwwwwwwwwwwwwwww