wwwwwwwwwwwwwwww
w....www.......w
w....www.......w
w....ww........w
w.w....w.....1.w
w.....ww.......w
w.1.........wwww
w.........w....w
w.........w....w
w.A............w
w......w.......w
wwwwwwwwwwwwwwww