wwwwwwwwwwwwwwww
w..g.w........gw
w..g...........w
w..wwww........w
w.........ww...w
w.........w....w
w.........w.ww.w
w..............w
w.........wwwwww
w.A..w..+......w
w....w.........w
wwwwwwwwwwwwwwww