wwwwwwwwwwwwwwww
w....ww.......gw
w....ww........w
w....ww........w
w.w.w........1.w
www.w..........w
w.w..2......w..w
w.2.......w....w
w...2.....w.ww.w
w.1..w.........w
w..www.w.......w
wwwwwwwwwwwwwwww