wwwwwwwwwwwwwwww
w.........w....w
w....g.........w
w..ww..........w
w.w2w....1w..+ww
w.w........ww.ww
w....wwwww.....w
w..........2...w
w....ww....2...w
w.......w......w
w..w...........w
wwwwwwwwwwwwwwww