wwwwwwwwwwwwwwww
w..ww.w..w.....w
w....www.......w
w....w.2.......w
w.w....2.....+.w
w..............w
w.........w..w.w
w........w.2...w
w.....w.w......w
wA......+......w
w..............w
wwwwwwwwwwwwwwww