wwwwwwwwwwwwwwww
w..g.ww........w
w....ww........w
w..w.ww........w
w............www
w............www
w....2....wwwwww
w.........w....w
w...2w.w..w....w
w....w.w+......w
w.wwww.w.......w
wwwwwwwwwwwwwwww