wwwwwwwwwwwwwwww
w.w...........gw
w.ww...........w
w..w...........w
w......1..w.ww.w
w..ww2....www..w
w..............w
w..........+...w
w......w...2...w
w.A..w.w+......w
w......w.......w
wwwwwwwwwwwwwwww