wwwwwwwwwwwwwwww
w.............gw
w..............w
w.......w......w
w.w2w..ww....+.w
www.w2www......w
w..........wwwww
w.2............w
w.....ww..w....w
w.A............w
w..w...........w
wwwwwwwwwwwwwwww