wwwwwwwwwwwwwwww
w.........w.1..w
wA.............w
w..w...ww......w
w..2...ww.w..+.w
w....wwww.www.ww
w..............w
w..........+...w
w..........w.w.w
w.....1.......ww
w..............w
wwwwwwwwwwwwwwww