wwwwwwwwwwwwwwww
w.............gw
wA...g.........w
w..wwwwww......w
w.......www..+ww
www.ww.wwwwww.ww
w..............w
w..........2...w
w....ww....2...w
w.A............w
w..w...........w
wwwwwwwwwwwwwwww