wwwwwwwwwwwwwwww
w.........w...gw
w..............w
w..w.ww........w
w...w........+.w
wwwww2....www.ww
w.........w....w
w..............w
w...2w.w..w.wwww
w..............w
w..............w
wwwwwwwwwwwwwwww