wwwwwwwwwwwwwwww
w..g..ww......gw
w....www.......w
w...www........w
w.w.w........+1w
w.w.........w.ww
w........wwwwwww
w.........w....w
w...2w....w..w.w
w..............w
wwwwww.........w
wwwwwwwwwwwwwwww