wwwwwwwwwwwwwwww
w.....w.......gw
wA.............w
w..w...........w
w......w.....+ww
w...wwwwwwwww.ww
w..............w
w..............w
w......w..w.ww.w
w..............w
w..............w
wwwwwwwwwwwwwwww