wwwwwwwwwwwwwwww
w.........w....w
wAw.www........w
w.w..ww........w
w.w.w........+ww
www.w.w....ww..w
ww1..ww.w....w.w
w..........2...w
w..w......w....w
w...........1..w
w......w.......w
wwwwwwwwwwwwwwww