wwwwwwwwwwwwwwww
w.....ww......gw
w....gw........w
w...www........w
w.w.w.....w..+.w
w....2.........w
w....ww1..w.wwww
w.........w....w
w....w.ww.w..w.w
w2...w.ww.....ww
w..............w
wwwwwwwwwwwwwwww