wwwwwwwwwwwwwwww
w.............gw
wA.............w
w..w.ww........w
w..2.........+.w
www.w....1..w.ww
w..............w
w........w.2...w
w...2..w...2w..w
w..............w
ww..w..........w
wwwwwwwwwwwwwwww