wwwwwwwwwwwwwwww
w.........w...gw
w..............w
w..............w
w.w2w.....w..1.w
www.w2.........w
www..2.1..wwwwww
w.........w+...w
w.........w2ww.w
w1.............w
w..............w
wwwwwwwwwwwwwwww