wwwwwwwwwwwwwwww
w.........w.1.gw
w..............w
w..............w
w..............w
w....www.......w
w....w.....ww..w
w.........w+...w
w......w..w.ww.w
wA.....w+......w
w......w.......w
wwwwwwwwwwwwwwww