wwwwwwwwwwwwwwww
w..............w
w....g.........w
w..w.w.........w
w............www
w..........w...w
w..w.wwww.w....w
w..........2...w
w...2w....w....w
w..............w
w..............w
wwwwwwwwwwwwwwww