wwwwwwwwwwwwwwww
w........ww...gw
wA.............w
w...w..........w
w...w..w..w....w
w...w2.........w
w.........wwwwww
w..........+...w
w............www
wA...w2w.......w
w..............w
wwwwwwwwwwwwwwww