wwwwwwwwwwwwwwww
w.............gw
w...wwww.......w
w......ww......w
w.w.w..www...+.w
wwwww2wwww.ww.ww
www............w
w.2........2...w
w.........w2...w
w.A.........1..w
w..............w
wwwwwwwwwwwwwwww