wwwwwwwwwwwwwwww
w...w.ww......gw
w...wwww.......w
w..............w
w.w.w..w.....1.w
w.....w........w
ww........wwwwww
w..............w
w.........w..w.w
w.A.......w....w
w..............w
wwwwwwwwwwwwwwww