wwwwwwwwwwwwwwww
w......w..w...gw
wA.............w
w.....www......w
w......ww......w
w..ww.www......w
w.........wwwwww
w..........+...w
w............www
w....w.........w
www.w..........w
wwwwwwwwwwwwwwww