wwwwwwwwwwwwwwww
w..g.www.......w
w....www.......w
w..............w
w.w.w..w..wwwwww
w.w.w2ww......ww
w.........www..w
w.21.......+...w
w......ww.w..www
wA.............w
w......w.......w
wwwwwwwwwwwwwwww