wwwwwwwwwwwwwwww
w..w.w....w...gw
wA.............w
w..www.........w
w.www..w..w....w
www.............
w.........wwwwww
w.........ww...w
w..w......w..w.w
w....w........ww
w..............w
wwwwwwwwwwwwwwww