wwwwwwwwwwwwwwww
w..g..w.....g.gw
w..............w
w.w.ww.........w
w.www........+.w
w.w............w
w.1..wwwwwwwwwww
w.........ww...w
w....w..w.w..w.w
w.A..w.ww.....ww
w..............w
wwwwwwwwwwwwwwww