wwwwwwwwwwwwwwww
w..g.www..w.g..w
w....gw........w
w.w.www........w
w.w.w........+.w
w.w............w
w.1..wwwwwwwwwww
w.........w....w
w..w....w.w..w.w
wA.....ww.w....w
ww.............w
wwwwwwwwwwwwwwww