wwwwwwwwwwwwwwww
w.....www.....gw
w....g.....1w..w
w..ww..........w
w...w........+.w
w.w.w2....www..w
w....wwwwww..w.w
w.........w....w
w..w2wwww....w.w
w....w.ww.+....w
w..............w
wwwwwwwwwwwwwwww