wwwwwwwwwwwwwwww
w.....w........w
wA....w........w
w...www2.......w
w.w.w.......w+ww
www.w......wwwww
w.1..wwwwwwwwg.w
w..............w
w..w.w.ww......w
w.1..w.ww.1....w
w.w............w
wwwwwwwwwwwwwwww