wwwwwwwwwwwwwwww
ww.1w.w...w....w
wA....w.....1..w
w....ww........w
w......2.....1.w
w..............w
w.....w...wwwwww
w..............w
w..w..www......w
w..............w
w..............w
wwwwwwwwwwwwwwww