wwwwwwwwwwwwwwww
ww........w...gw
wA...w.....1...w
w...w..........w
w...w.....ww.+ww
w.....w.......ww
w.........w.w..w
w..........+...w
w..w...w..w2.www
wA.....w..w....w
w..............w
wwwwwwwwwwwwwwww