wwwwwwwwwwwwwwww
w....wwww.w...gw
w....ww........w
w..w.ww........w
w...w..........w
w.w..2.........w
w....1...wwwwwww
w.........w....w
w...2.....w....w
w..............w
w......w.......w
wwwwwwwwwwwwwwww