wwwwwwwwwwwwwwww
w.....ww......gw
wA..w.ww.......w
w..............w
w.w.w..w.....+.w
www.w.ww.......w
w....www.wwwwwww
w.........w....w
w..............w
w.............ww
w..w...........w
wwwwwwwwwwwwwwww