wwwwwwwwwwwwwwww
w.........w....w
wA..w..........w
w...w..........w
w...w..w.wwww+ww
ww.wwwww..ww...w
w..............w
w........w.2...w
w.w........2...w
w..............w
w..............w
wwwwwwwwwwwwwwww