wwwwwwwwwwwwwwww
w.............gw
wA.....w.......w
w..............w
w...w..w.......w
w.wwwww.....w..w
w..............w
w..........2...w
w..........2...w
w..............w
w..............w
wwwwwwwwwwwwwwww