wwwwwwwwwwwwwwww
w.....ww......Aw
wA....w........w
w...www........w
w..ww.....w.w+ww
www.w....wwwwwww
w.w......ww....w
w.2............w
w....w..w......w
w....w....1....w
w.w............w
wwwwwwwwwwwwwwww