wwwwwwwwwwwwwwww
ww..........1..w
w..............w
w..............w
w.w.w..w.w...+.w
w.....w....ww..w
ww...wwwww.....w
w..........2...w
w..w.......2....
wA.............w
w..............w
wwwwwwwwwwwwwwww