wwwwwwwwwwwwwwww
w..............w
wA.............w
w..wwww........w
w.........www+ww
w.w2......www.ww
w....w.11......w
w..........2...w
w...2ww.w..w.w.w
w....ww.w......w
w..............w
wwwwwwwwwwwwwwww