wwwwwwwwwwwwwwww
w.............Aw
wA...g.........w
w..w..www......w
w.......www..+ww
wwwwwwwww..ww.ww
w.....wwww.....w
w..........+...w
w...2w.ww......w
w.........+....w
w..............w
wwwwwwwwwwwwwwww