wwwwwwwwwwwwwwww
w.....ww.......w
w....g.........w
ww..w.ww.......w
ww.....w.....+.w
w....ww..w.ww..w
w....ww........w
w..........+...w
w.....www......w
wA.............w
w..............w
wwwwwwwwwwwwwwww