wwwwwwwwwwwwwwww
w.............gw
w..............w
w..w..w.w......w
w.......w.w....w
w..ww2....w....w
w.........wwww.w
w.........w+...w
w......w..w..w.w
wA......+.....ww
w......w.......w
wwwwwwwwwwwwwwww