wwwwwwwwwwwwwwww
w....w....w...gw
w.w..w.........w
w.w............w
w.w.w..........w
www.w2.........w
www..2....wwwwww
w..............w
w......w..w..w.w
w.A..w.w......ww
w......w.......w
wwwwwwwwwwwwwwww