wwwwwwwwwwwwwwww
w......w....1..w
wA.............w
w..w..www......w
w..2...w.......w
w..ww......ww.ww
w.....w....w.www
w..........2...w
w.....w.w..2.www
wA....2........w
w..............w
wwwwwwwwwwwwwwww