wwwwwwwwwwwwwwww
w.....ww..w....w
w....g.........w
w..w.ww........w
w.........w..+.w
w....ww...ww...w
w.........w....w
w..........+...w
w....w.ww......w
w.A............w
w......ww......w
wwwwwwwwwwwwwwww