wwwwwwwwwwwwwwww
w.....ww..w....w
w....gw........w
w...www........w
w...w.....w.wwww
ww..w2.........w
ww...wwwwwwwwwww
w.........ww...w
w......w.......w
w..............w
w..............w
wwwwwwwwwwwwwwww