wwwwwwwwwwwwwwww
w....www..w...gw
w..............w
w..wwww........w
w.........w1...w
w..w.2.........w
w....2....wwwwww
w.2............w
w...2w....w..www
w.A..w.........w
w...ww.........w
wwwwwwwwwwwwwwww