wwwwwwwwwwwwwwww
w......w..w...gw
w....w.........w
w...w..........w
w.w.w........+.w
www.w2....w.w..w
www.......w....w
w..............w
w....w....w2w..w
w....w......1..w
w..............w
wwwwwwwwwwwwwwww