wwwwwwwwwwwwwwww
w......w......gw
w..............w
w..............w
w...w....wwww+.w
ww.ww2w...www.ww
w.........w....w
w..........+...w
w......w...2..gw
w..............w
w..............w
wwwwwwwwwwwwwwww