wwwwwwwwwwwwwwww
w.........w...gw
wA.............w
w.w.w..........w
www2w....wwwwwww
www.w.....wwww.w
w...ww..w.ww.www
w..........w...w
w....w..w......w
w.A..w........ww
w..............w
wwwwwwwwwwwwwwww