wwwwwwwwwwwwwwww
w.........w....w
w....g.........w
wwww...........w
www.......www+ww
www.w.w....w...w
ww...wwwwwww...w
w..........w...w
w...ww.w.......w
w.A............w
w......w.......w
wwwwwwwwwwwwwwww