wwwwwwwwwwwwwwww
w.........w.g..w
wA.............w
w......2.......w
w.w.w..........w
www.w.w........w
w.....w.w.w....w
w..1.......2...w
w......w...2...w
w.1....w+.....ww
w......w.......w
wwwwwwwwwwwwwwww