wwwwwwwwwwwwwwww
w.....ww..w...gw
w....w.........w
w..............w
w...w.....w..+ww
www.w2w....ww.ww
w.........w....w
w..........+...w
w......ww.w....w
w.1.........1..w
w..w...........w
wwwwwwwwwwwwwwww