wwwwwwwwwwwwwwww
w.....ww.ww.g..w
w....www.......w
w......1.......w
w.w.w..w.......w
w..............w
w........w.wwwww
w..........+...w
w..............w
wA..........1..w
w..............w
wwwwwwwwwwwwwwww