wwwwwwwwwwwwwwww
w.............gw
w......w.......w
w..............w
w..2w..w.....+.w
www.w.........ww
w....2.........w
w..........2...w
w.........w2wwww
wA....1.2......w
w..............w
wwwwwwwwwwwwwwww