wwwwwwwwwwwwwwww
ww.....w.w..g.gw
w......w.......w
w......w.......w
w...w..w.w...+.w
w...w2w..wwww..w
w........ww....w
w.2......w.2...w
w..........2...w
w.A............w
w..............w
wwwwwwwwwwwwwwww