wwwwwwwwwwwwwwww
w.....ww....g..w
w..............w
w...w.w........w
w............+.w
ww..w.w........w
w.....w...w.wg.w
w.........w....w
w...wwww..w..w.w
w.A..w.........w
w..w.w.........w
wwwwwwwwwwwwwwww