wwwwwwwwwwwwwwww
w.............gw
wA..........w..w
w....ww........w
w.www........+ww
wwwww.....wwwwww
www..2....w....w
w.2............w
w....w....w2...w
w.A..w.........w
w..............w
wwwwwwwwwwwwwwww