wwwwwwwwwwwwwwww
w.....ww......gw
wA...www.......w
w....w.w.......w
w...w..w.....+.w
w.w.wwwwww.ww.ww
w...........w..w
w..1.......2...w
w......ww....w.w
w.1............w
w..............w
wwwwwwwwwwwwwwww