wwwwwwwwwwwwwwww
w.www.....w...gw
w....g.........w
w.w.ww.........w
w.www........1.w
w..............w
w....w..wwwwwwww
w..............w
w..............w
w.A............w
w..............w
wwwwwwwwwwwwwwww