wwwwwwwwwwwwwwww
w..............w
wA.....w.......w
w.....www......w
w.w2w..www...+ww
wwwww2wwwwwww.ww
www............w
w.2........2...w
w.....ww...2...w
w......w+......w
w......w.......w
wwwwwwwwwwwwwwww