wwwwwwwwwwwwwwww
ww.w..ww......gw
wA.............w
w...ww.........w
w...w..........w
w...........w..w
w....w..1......w
w..........+...w
w..w.w..w....w.w
w..1.w..w......w
w..............w
wwwwwwwwwwwwwwww