wwwwwwwwwwwwwwww
w.........w.g..w
wA.............w
w......w.......w
w..2w..wwww....w
wwwww2www.w....w
w..........w.gww
w.2........2...w
w......w...2...w
w.A.........1..w
w..............w
wwwwwwwwwwwwwwww