wwwwwwwwwwwwwwww
ww....ww.......w
wA...gw....1w..w
w...www2.......w
w.w.w........+ww
w.........wwwwww
ww1..wwww.w..w.w
w..............w
w..w.wwww......w
w.1..w.ww......w
w..............w
wwwwwwwwwwwwwwww