wwwwwwwwwwwwwwww
w.............Aw
w....g......w..w
w..ww.w.w......w
w...w...w....+ww
wwwww.w.w..ww..w
ww....w........w
w..............w
w...ww.w...2...w
w.A....w....1..w
w......w.......w
wwwwwwwwwwwwwwww