wwwwwwwwwwwwwwww
w......w.......w
w......w.......w
w.....www......w
w..2...www...+ww
wwwww2wwwwwwwwww
w..............w
w.22.......2...w
w.....www..2...w
w.A....w+......w
w.....ww.......w
wwwwwwwwwwwwwwww