wwwwwwwwwwwwwwww
w.............gw
wA...g.........w
w..ww.www......w
w.......ww.w.www
w.w....wwwwww.ww
w.............ww
w.2............w
w...2wwww......w
w....w.........w
w...w..........w
wwwwwwwwwwwwwwww