wwwwwwwwwwwwwwww
w.............gw
w....g.........w
w..w.w.........w
w.w..........+ww
www.w2....www..w
w....ww1w......w
w.2........2...w
w...2ww....w...w
w..............w
w..............w
wwwwwwwwwwwwwwww