wwwwwwwwwwwwwwww
w..g..ww......gw
w....ww........w
w..............w
w.w.w..........w
www.w.......w..w
w.........w.w..w
wA21...........w
w.......w.w.wwww
w....w..w......w
w..............w
wwwwwwwwwwwwwwww