wwwwwwwwwwwwwwww
w.....ww.......w
wA...www.......w
w..............w
w.w.w..w.....www
wwwww2ww......ww
w.w............w
w.2............w
w......w...2...w
w......w+......w
w...w..w.......w
wwwwwwwwwwwwwwww