wwwwwwwwwwwwwwww
w.....1w......Aw
wA.............w
w..............w
w...w.......w+ww
w.w.w.........ww
w....www.w..w.ww
w..........+...w
w....wwww.w...ww
w....w..w......w
w..............w
wwwwwwwwwwwwwwww