wwwwwwwwwwwwwwww
w......w..w...gw
wA.............w
w...ww.........w
w...w..1.....1.w
w..............w
w.....11.ww..w.w
w........w.....w
w..........2...w
w....w......1..w
w..............w
wwwwwwwwwwwwwwww