wwwwwwwwwwwwwwww
w.1...w........w
w....g......w..w
w.w.ww.........w
w...w.....w..+ww
w..........wwwww
w.1..ww.www....w
w..........2...w
w..........2...w
w.A.....w......w
w..............w
wwwwwwwwwwwwwwww