wwwwwwwwwwwwwwww
w.....ww....1..w
w....www.......w
w....ww........w
w...w..w.....+.w
w.....ww...wwwww
w.1...w........w
w.........w....w
w.......w......w
wA......+......w
w......w.......w
wwwwwwwwwwwwwwww