wwwwwwwwwwwwwwww
w..g........1..w
w..............w
w..wwww........w
w..2...w.....+ww
w......wwwwww.ww
w..............w
w..........2...w
w.....www..2...w
w......w+......w
w......w.......w
wwwwwwwwwwwwwwww