wwwwwwwwwwwwwwww
w..w..w.......gw
w.w..ww........w
w.w..w.........w
w.w.w........+ww
www.w.....w.w..w
w.w.......w....w
w.2.......w....w
w....w.ww.w.ww.w
w.A..w..+......w
w....w.w.......w
wwwwwwwwwwwwwwww