wwwwwwwwwwwwwwww
w.............gw
w....www.......w
w..............w
w.w.w..w.......w
w....wwwww..w..w
w..............w
w..........w...w
w..........w.w.w
w..............w
w..............w
wwwwwwwwwwwwwwww