wwwwwwwwwwwwwwww
w....w....w...gw
w..g...........w
w..............w
w...w..........w
www.w.w........w
w....w....wwwwww
w.........w....w
w.........w.ww.w
w.A..w........ww
w..w...........w
wwwwwwwwwwwwwwww