wwwwwwwwwwwwwwww
w.............gw
wA.............w
w..ww.www......w
w......www.w.+.w
w.....wwwww...ww
w..............w
w..........w...w
w.....ww...w.www
w..............w
w..............w
wwwwwwwwwwwwwwww