wwwwwwwwwwwwwwww
w.........w...gw
w..............w
w..w...........w
w.........ww.+ww
wwwwwww...www..w
w.......1......w
w..........+...w
w..........w.w.w
w.A..w........ww
w..............w
wwwwwwwwwwwwwwww