wwwwwwwwwwwwwwww
w.....ww......Aw
w....g.........w
w.....www......w
w.w....wwwwwwwww
ww..w2wwwwwwwwww
ww....w........w
w..........2...w
w.....www......w
w1.....ww.w....w
w......w.......w
wwwwwwwwwwwwwwww