wwwwwwwwwwwwwwww
w...........g..w
w..............w
w..ww.w.w......w
w..2.........+.w
w..wwwwww......w
w............w.w
w.........w+...w
w.....ww..w..w.w
wA.....w+.....ww
w......w.......w
wwwwwwwwwwwwwwww