wwwwwwwwwwwwwwww
w.g..w....w.g..w
w..............w
w..............w
w.w2w..1.1wwww.w
www.w..........w
w....2..1.wwwg.w
w..1.......2...w
w.............ww
w.A1.w.........w
w..............w
wwwwwwwwwwwwwwww