wwwwwwwwwwwwwwww
w....www..w.g.gw
w..g...........w
w..www.........w
w.........w..1.w
www.w.....www..w
w....w.1wwwwww.w
w.........w....w
w...2w....w....w
w.A..w.........w
w..w.w.........w
wwwwwwwwwwwwwwww