wwwwwwwwwwwwwwww
w.........w....w
w....g.........w
w..w.ww........w
w.w2.........www
w.ww.2.ww..w...w
w.ww.2.....w.www
w.2.......12...w
w.....www......w
w......w+......w
w......w.......w
wwwwwwwwwwwwwwww