wwwwwwwwwwwwwwww
w.........w...gw
w...ww.w.......w
w......w.......w
w.w.w..w..w..+.w
w.w1..w........w
w.....w..wwwwwww
w..........w...w
w.......w.w..www
wA......w......w
w..............w
wwwwwwwwwwwwwwww