wwwwwwwwwwwwwwww
w......w..w...gw
wA...w.w.......w
w..............w
w.w.w..w..w....w
wwwww2.........w
w.........www..w
w.2......w.2...w
w..........2.www
w...........1..w
w...w..w.......w
wwwwwwwwwwwwwwww