wwwwwwwwwwwwwwww
w..g.ww.......Aw
w....g.........w
w..w.ww........w
w.w........wwwww
www...........ww
w.w.12.wwwwwwwww
w.2.......w....w
w....w....w....w
w.A..w.........w
w..............w
wwwwwwwwwwwwwwww