wwwwwwwwwwwwwwww
w........ww.g.gw
wA.............w
w......w.......w
w...w..w.....+.w
w..1..w........w
w..............w
w..........2...w
w......w...2.www
wA....2w....1..w
w..............w
wwwwwwwwwwwwwwww