wwwwwwwwwwwwwwww
w.....w........w
w....gw........w
w.w...w........w
w.w....w.wwwwwww
w.w.w.ww.www...w
w....wwww......w
w..........2...w
w..w.wwww..2...w
w....w.ww.w....w
w..........w...w
wwwwwwwwwwwwwwww