wwwwwwwwwwwwwwww
w..w.www..w...Aw
w....g.........w
w...w..........w
w...w.....w..+.w
w.w.......wwww.w
w....1....wwwwww
w..............w
w....w.ww.w..www
wA...w.........w
w..............w
wwwwwwwwwwwwwwww