wwwwwwwwwwwwwwww
w.........w...gw
w..............w
w..w..w........w
w..2....w.w....w
ww.ww2.ww.w....w
w....2....wwwwww
w.2............w
w...2..w..w.wwww
w.A....w.......w
w...w..w.......w
wwwwwwwwwwwwwwww