wwwwwwwwwwwwwwww
w.........w....w
w..............w
w......w.......w
w..2w..w.ww..w.w
wwwww2ww.......w
ww.............w
w..........2...w
w......w...2...w
wA.....w+......w
w......w.......w
wwwwwwwwwwwwwwww