wwwwwwwwwwww.www
w.........w...gw
wAw.......w....w
w...w..........w
w...w..w.....+.w
www.w.w........w
ww...ww..wwwwwww
w........www...w
w..w2w.........w
w..............w
w..............w
wwwwwwwwwwwwwwww