wwwwwwwwwwwwwwww
w.....ww.......w
w....www.......w
w....w.........w
w.w.w..w.wwwwwww
www.w2....wwwwww
w....2..w.w....w
w..........2...w
w..............w
w.A..w.........w
w...ww.........w
wwwwwwwwwwwwwwww