wwwwwwwwwwwwwwww
w.............gw
w....w.w.......w
w..............w
w.w.w..w.......w
w.w.w.......w..w
w............w.w
w.2......w.....w
w..........w.w.w
w.2............w
w..............w
wwwwwwwwwwwwwwww