wwwwwwwwwwwwwwww
w.w.......w...gw
w..............w
w..2...ww......w
w..2...wwwww...w
wwwww2.........w
w.........wwwwww
w..........+...w
w............www
wA....2.......ww
w..............w
wwwwwwwwwwwwwwww