wwwwwwwwwwwwwwww
w......w.......w
wA...g.w.......w
w...w..........w
w.w.w..w..wwwwww
w...w2.......w.w
w....2...wwwwwww
w......w..w....w
w..............w
wA.....w.......w
w......w.......w
wwwwwwwwwwwwwwww