wwwwwwwwwwwwwwww
w..............w
w......w.......w
w..............w
w..2...w.w...+ww
w.www2www.....ww
w..............w
w..1.......2...w
w......w..w2...w
wA..........1..w
w1.....w.......w
wwwwwwwwwwwwwwww