wwwwwwwwwwwwwwww
w.....w...w...Aw
w....g....w1w..w
w..w..w........w
w............+.w
w.....w........w
w....wwwww.www.w
w.........ww...w
w..w.wwww.w..w.w
wA...w.ww.w.1..w
w..............w
wwwwwwwwwwwwwwww