wwwwwwwwwwwwwwww
w....w.w..w.g..w
w......w.......w
w......1.......w
w..2w..w..w.w..w
w..1w2....www..w
w..............w
w........w.2...w
w..........2...w
wA......2......w
w..........w...w
wwwwwwwwwwwwwwww