wwwwwwwwwwwwwwww
w......w..w...gw
wA.....w.......w
w..............w
w...w........+.w
wwwww2w........w
w.w........www.w
w.2........+...w
w.........w..w.w
w1.............w
w......w.......w
wwwwwwwwwwwwwwww