wwwwwwwwwwwwwwww
w......w......gw
w....www.......w
w..............w
w...w..w.....1.w
w.....ww.......w
w.....w....wwwww
w.........w+...w
w.......w.w....w
w.A............w
w..............w
wwwwwwwwwwwwwwww