wwwwwwwwwwwwwwww
w.....ww....1..w
w.....ww.......w
w....www.......w
w.w.w..2.....+.w
w.w.w.ww.......w
ww....www..wwwww
w.........ww...w
w.....www.w....w
wA.....ww......w
w......w.......w
wwwwwwwwwwwwwwww