wwwwwwwwwwwwwwww
w....www..w.1.gw
ww..w.w........w
w...w..........w
w...w.....w1...w
w..............w
w....www.wwwwwww
w..............w
w..w.w..w.w....w
w....w.........w
w..............w
wwwwwwwwwwwwwwww