wwwwwwwwwwwwwwww
w..w..w.......gw
w..w.gw........w
w.ww.ww........w
w.........w..+.w
w.........www..w
w....ww.w.w....w
w..........+...w
w..............w
w..............w
w..............w
wwwwwwwwwwwwwwww