wwwwwwwwwwwwwwww
w..g.w....w....w
w....g.........w
w..w.ww........w
w..2.........+.w
w..............w
w....ww.1.wwww.w
w..........+...w
w.........w..w.w
wA............ww
w......w.......w
wwwwwwwwwwwwwwww