wwwwwwwwwwwwwwww
w..g..w.......Aw
w....gw........w
w...ww.........w
w.w.w........+ww
w.....w....ww..w
ww...wwwwwwwww.w
w.........w....w
w....w....w..w.w
wA..........1..w
w..............w
wwwwwwwwwwwwwwww