wwwwwwwwwwwwwwww
w.............gw
wA.............w
w.......w......w
w...w........+.w
www.www.....w..w
www............w
w..............w
w....w.ww.w..w.w
w.............ww
w..............w
wwwwwwwwwwwwwwww