wwwwwwwwwwwwwwww
w..w.ww...w...gw
w....ww........w
w....ww........w
w.w.......ww.+.w
w.....w.w.w....w
w....w..w.wwwg.w
w..............w
w.........w.wwww
w.A1.w.w.......w
w......ww......w
wwwwwwwwwwwwwwww