wwwwwwwwwwwwwwww
w.............gw
wA....w........w
w...www........w
w...w........+.w
w.....w.....w..w
w..............w
w..............w
w..........1.w.w
w....w......1..w
www............w
wwwwwwwwwwwwwwww