wwwwwwwwwwwwwwww
w.....ww..w....w
w.....ww.......w
w.....www......w
w.w2...wwww..+ww
www.wwwwwwwwwwww
w.........w..g.w
w.2............w
w.....www......w
w.A............w
w..............w
wwwwwwwwwwwwwwww