wwwwwwwwwwwwwwww
w.....ww..w....w
w....www....w..w
w....w.........w
w.w.w..2.....+ww
www.w2......w.ww
www.......w....w
w.2............w
w....wwww..2...w
w.A..w.ww......w
w..............w
wwwwwwwwwwwwwwww