wwwwwwwwwwwwwwww
w.............gw
wA.............w
w..w..w........w
w..2...w.....+ww
w.............ww
w..........wwwww
w..........+...w
w.........w...ww
wA.............w
w..............w
wwwwwwwwwwwwwwww