wwwwwwwwwwwwwwww
w.............gw
wA..........w..w
w.....www......w
w..2w..www...+.w
w..ww.wwwww.w.ww
w.....w........w
w..........2...w
w......ww..w.www
w1.....ww......w
w..........w...w
wwwwwwwwwwwwwwww