wwwwwwwwwwwwwwww
w..w..ww.......w
w....www.......w
w....ww........w
w............+ww
w.....w........w
ww1...w..wwwww.w
w.........w....w
w..w...ww.w....w
w..............w
w..............w
wwwwwwwwwwwwwwww