wwwwwwwwwwwwwwww
w....www.......w
w....www.......w
w....ww........w
w...w..w.....+.w
w..............w
ww....w........w
w..........2...w
w......wwww2...w
w1..........1..w
w..............w
wwwwwwwwwwwwwwww