wwwwwwwwwwwwwwww
w.........w...gw
w....g....w....w
w..w..www......w
w......ww..w.+.w
w.....www......w
w.....w....wwwww
w..........+...w
w.....www....www
wA.............w
w..............w
wwwwwwwwwwwwwwww