wwwwwwwwwwwwwwww
w.........w....w
w..........11..w
w..............w
w...w........+.w
w....ww........w
w....w111......w
w.....1....2...w
w.........w2.w.w
wA..........1..w
w..............w
wwwwwwwwwwwwwwww