wwwwwwwwwwwwwwww
w......w..w...gw
w..............w
w..www.........w
w...w........+.w
w..............w
w....2.1wwwwwwww
w..........2...w
w...2..........w
w.A..w.........w
w..............w
wwwwwwwwwwwwwwww