wwwwwwwwwwwwwwww
w...........1..w
w......w.......w
w..w...w.......w
w......w.......w
w..ww2ww.......w
w..............w
w..1.......2...w
w..........2.www
wA....1.2......w
w......w.......w
wwwwwwwwwwwwwwww