wwwwwwwwwwwwwwww
w..w..w........w
w....g.........w
w.ww.ww........w
w.w2......w.ww.w
w.........wwww.w
w....w.1.......w
w.2........+...w
w.........wwww.w
w.A..w.........w
w..............w
wwwwwwwwwwwwwwww