wwwwwwwwwwwwwwww
w.....ww.......w
w.....w........w
w.....www......w
w.w2...www...+ww
w.....wwwww.w.ww
w..............w
w..........2...w
w.....w....2...w
w..............w
w..............w
wwwwwwwwwwwwwwww