wwwwwwwwwwwwwwww
w.........w....w
w....ww........w
w.w..w.........w
w.w.w..w.....+.w
w.w..www.......w
w.1..ww.w.wwww.w
w.........w....w
w.........w..w.w
w...........1..w
w......w.......w
wwwwwwwwwwwwwwww