wwwwwwwwwwwwwwww
w......w.ww...gw
w...wwww.......w
w..............w
w.w.w..w.....+.w
w.w1wwww.......w
w.........w....w
w..1...........w
w......ww.w2...w
wA..........1..w
w..............w
wwwwwwwwwwwwwwww