wwwwwwwwwwwwwwww
w......w......gw
wAAg...........w
w...www.w......w
w...w........+.w
wwwww.....www..w
w..............w
w........ww....w
w...2www...2ww.w
w....w.w+......w
wwwwww.........w
wwwwwwwwwwwwwwww