wwwwwwwwwwwwwwww
w..g......w....w
wA...g.........w
w..wwwwww......w
w......ww.www+ww
w......wwwwwwwww
w.....w.w......w
w..........2...w
w.....w....2...w
w..............w
w..............w
wwwwwwwwwwwwwwww