wwwwwwwwwwwwwwww
w....w........gw
w......w.......w
w......1.......w
w...w..w.ww.w+.w
www.w......ww.ww
w..............w
w..1.......2...w
w..........2...w
w.1.........1..w
w..............w
wwwwwwwwwwwwwwww