wwwwwwwwwwwwwwww
w....wwwwww...gw
w....www.......w
w....ww........w
w...w..w..w....w
www..2.........w
w........wwwwwww
w..........+...w
w...2.....w....w
w..............w
w..ww..........w
wwwwwwwwwwwwwwww