wwwwwwwwwwwwwwww
w.....ww.......w
w....g.........w
w..............w
w...w........w.w
w....2.........w
w......w..w....w
w..1...w..w2...w
w......ww......w
wA.....w+......w
w......ww......w
wwwwwwwwwwwwwwww