wwwwwwwwwwwwwwww
ww....ww.ww.1.gw
ww.............w
w...w..........w
w.w.w..........w
w.....w........w
ww...ww...wwwwww
w.........w....w
w..w.w....w..w.w
w..............w
w..............w
wwwwwwwwwwwwwwww