wwwwwwwwwwwwwwww
w....www.......w
w....ww........w
w...ww.........w
w...w........+.w
www.w.......w..w
ww...ww.w.w.ww.w
w.........w.1..w
w....w..w.w....w
w....w......1..w
w..............w
wwwwwwwwwwwwwwww