wwwwwwwwwwwwwwww
w......w..w....w
w....g.w.......w
w..............w
w.w....w.ww..+ww
w.w1w2....www.ww
w..............w
w..........2...w
w..........2.w.w
wA.............w
w..............w
wwwwwwwwwwwwwwww