wwwwwwwwwwwwwwww
w........ww...gw
wA.............w
w......w.......w
w.w2w..w.ww.w+ww
wwwww2.....w..ww
www............w
w.2......w.2...w
w......ww..2...w
w......w....1..w
w..............w
wwwwwwwwwwwwwwww