wwwwwwwwwwwwwwww
w....www.ww.g..w
w.....w........w
w....w.........w
w...w........+.w
w...w2w........w
w....w..1.w.ww.w
w.........w....w
w..w.w.ww.w..w.w
w....w..w.....ww
w..............w
wwwwwwwwwwwwwwww