wwwwwwwwwwwwwwww
w.....ww......gw
w.....w........w
w....w.........w
w...w........+.w
w...ww....wwww.w
w....w....w....w
w.........w....w
w....w.w..w.ww.w
w.A..w..+......w
w....w.w.......w
wwwwwwwwwwwwwwww