wwwwwwwwwwwwwwww
w.....w.......gw
wA...gw........w
w.w.ww.2.......w
w.w.......w.w+ww
w.w.www....ww..w
w....wwwww.....w
w..........w...w
w....ww.w......w
w.A............w
w..w...........w
wwwwwwwwwwwwwwww