wwwwwwwwwwwwwwww
w.....ww......Aw
w....g.........w
w...w..........w
w...w.....wwwwww
www.w2w...wwwwww
w......w.ww.w..w
w..............w
w...2w.w..w....w
w..............w
w..ww..........w
wwwwwwwwwwwwwwww