wwwwwwwwwwwwwwww
w.....ww.......w
wA...gw........w
w..w.ww........w
w.w..........www
w....2.....w...w
w....2....ww.w.w
w.2.......w....w
w....w.ww......w
w....w.w+......w
w......w.......w
wwwwwwwwwwwwwwww