wwwwwwwwwwwwwwww
w.........w....w
wA.............w
w......1.......w
w..2w..w.....+.w
www.w..........w
ww....w.w......w
w..........2...w
w..........2...w
wA....2.....1..w
w..............w
wwwwwwwwwwwwwwww