wwwwwwwwwwwwwwww
w.........w...gw
w.wg...........w
w.w1...........w
w.w............w
w.w1...........w
w....wwww.wwww.w
w.........ww...w
w.........w....w
wA............ww
w..............w
wwwwwwwwwwwwww.w