wwwwwwwwwwwwwwww
w..............w
w.....ww.......w
w.....w........w
w.w.w........+.w
w....wwww......w
w..............w
w..............w
w......w..w2...w
wA.....w+...1..w
w......w.......w
wwwwwwwwwwwwwwww