wwwwwwwwwwwwwwww
w.....ww......gw
w...wwww.......w
w..............w
w.w.w..w.....+.w
w.w.w.......w..w
w....2....w.ww.w
w.2............w
w.......w.w2ww.w
w....w.ww......w
w..............w
wwwwwwwwwwwwwwww