wwwwwwwwwwwwwwww
w......w.w....gw
wA.....w.......w
w....ww........w
w...w..w.......w
w.w.w2......w.ww
w............www
w..............w
w..........2...w
w..............w
ww.............w
wwwwwwwwwwwwwwww