wwwwwwwwwwwwwwww
ww....w...w....w
wA...g.........w
w..ww.w........w
w............+ww
w.....w.......ww
w..w.ww.w.ww.www
w..........2...w
w......w.......w
wA......+.....ww
w......w.......w
wwwwwwwwwwwwwwww