wwwwwwwwwwwwwwww
w.....ww......gw
w......w.......w
w..............w
w...w..w.wwww+.w
wwwww2...wwww..w
w.........w....w
w..............w
w......w...2wwww
w....w.ww......w
w..............w
wwwwwwwwwwwwwwww