wwwwwwwwwwwwwwww
ww.w......w...gw
wAw............w
w.wwww.........w
w.w.w.....w.w+ww
w.........www..w
w....w..w.ww.w.w
w..........2...w
w..w.w.........w
w....ww.......ww
w..............w
wwwwwwwwwwwwwwww