wwwwwwwwwwwwwwww
w..g.ww.......gw
w....ww........w
w.wwww.........w
w.w.w..........w
www.w..........w
w....w...wwwww.w
w.2.......w....w
w...2w.w..w....w
w.A..w.w.......w
w..www.........w
wwwwwwwwwwwwwwww