wwwwwwwwwwwwwwww
ww..w.ww.ww...gw
ww.............w
ww.ww.ww.......w
ww..w.....w....w
w.........www..w
w.........w.ww.w
w..............w
w....w..w....www
w.A..w........ww
w....w.........w
wwwwwwwwwwwwwwww