wwwwwwwwwwwwwwww
ww....ww.......w
ww....w........w
w...w..........w
w...w..1.....+.w
w.....w........w
w....ww...w....w
w..1.....ww2...w
w............w.w
wA...w2.+......w
www1...........w
wwwwwwwwwwwwwwww