wwwwwwwwwwwwwwww
w...........1..w
w..g.g.........w
w..w...........w
w.w....www...+.w
w.wwwwwwwwwww..w
w.....w........w
w.....w....w...w
w.....w....w...w
w..............w
w..............w
wwwwwwwwwwwwwwww