wwwwwwwwwwwwwwww
w.gg.www......gw
w....www.......w
w....w.........w
w.1.w..w.......w
w..............w
w........w.....w
w..............w
w.........w2.w.w
wA........w.1..w
w..............w
wwwwwwwwwwwwwwww