wwwwwwwwwwwwwwww
ww....ww.......w
ww...gw.....w..w
w...www........w
w.........w..+ww
w.........wwwwww
w....www..w....w
w..............w
w..w.wwww......w
w....w.w+.+....w
w......w.......w
wwwwwwwwwwwwwwww