wwwwwwwwwwwwwwww
w.........w...gw
wA.............w
w..ww.www......w
w...w..2..w....w
w..ww2.........w
w........wwwwwww
w........w.+...w
w......w.....www
w....w......1.ww
w..............w
wwwwwwwwwwwwwwww