wwwwwwwwwwwwwwww
w..1.www......Aw
w....gw....1...w
w...www........w
w...w........+.w
www.........w..w
ww....wwwww.ww.w
w..............w
w......ww.w....w
wA.....ww.w....w
w..............w
wwwwwwwwwwwwwwww