wwwwwwwwwwwwwwww
w.....ww..w....w
wA...g.........w
w..w.ww........w
w............www
www.w..........w
w....w.wwwwwwwww
w.2.......w2...w
w....w.w.......w
w.A..w..w......w
w..w.w.........w
wwwwwwwwwwwwwwww