wwwwwwwwwwwwwwww
w..g.w......1..w
w....w.........w
w..w.ww........w
w..2.........+.w
w...........w..w
w....w11..w.ww.w
w.........w+...w
w.........w.ww.w
w.A..w.........w
w..............w
wwwwwwwwwwwwwwww