wwwwwwwwwwwwwwww
w......w......gw
wA.....w.......w
w.....ww.......w
w...w..w.....w.w
w...w2.........w
w........w.....w
w........w.+...w
w.....www......w
w..............w
w..............w
wwwwwwwwwwwwwwww