wwwwwwwwwwwwwwww
w.............gw
wA.............w
w..wwww.w......w
w..2.........+.w
wwwww.....wwww.w
w.........w..g.w
w.2............w
w...2w....w.ww.w
w....w.........w
w..www.........w
wwwwwwwwwwwwwwww