wwwwwwwwwwwwwwww
w.............gw
wA.g...........w
w..............w
w...w..2.....+.w
w...wwww..www.ww
w....ww........w
w..........w...w
w.....w.w......w
w..............w
w..............w
wwwwwwwwwwwwwwww