wwwwwwwwwwwwwwww
w.............gw
w..............w
w......ww......w
w.w2...www...+.w
w...wwwww.....ww
w...........w..w
w..1.......+...w
w.........w..www
wA....1.....1..w
w..............w
wwwwwwwwwwwwwwww