wwwgwwwwwwwwwwww
w.....ww......gw
w....gw........w
w.w............w
w.w.w..w.....www
w.w.w.w....w...w
w.1..www.www...w
w.2.......ww...w
w....ww........w
w.A...........ww
w..w...........w
wwwwwwwwwwwwwwww