wwwwwwwwwwwwwwww
w......w......gw
w......w.......w
w..............w
w..2w..........w
wwwww2.........w
w..........w.w.w
w.........w+...w
w......w..w...ww
w1......+......w
w..............w
wwwwwwwwwwwwwwww