wwwwwwwwwwwwwwww
w.........w...gw
w.wg...........w
w.w............w
w.w.w.....w....w
w.w.w2.........w
w.1..w..wwwwww.w
w.........ww...w
w..w....w.w....w
w....w.ww...1.ww
w..............w
wwwwwwwwwwwwwwww