wwwwwwwwwwwwwwww
w..g.ww...w...Aw
wA...ww........w
w....w.........w
w...w..2..ww.+ww
wwwww.w.....wwww
w.........wwww.w
w.2........+...w
w.........w..www
w.A..w.........w
w..............w
wwwwwwwwwwwwwwww