wwwwwwwwwwwwwwww
w....www..w.1..w
w..............w
w..wwww........w
w..2......w..1.w
w..2......w....w
w....w..1.wwwwww
w.........w+...w
w....w....w....w
w.A............w
w..............w
wwwwwwwwwwwwwwww