wwwwwwwwwwwwwwww
w..............w
w....g.........w
w..w..w.w......w
w.w....ww....+ww
wwwww.wwww.w..ww
w.....w........w
w..........w...w
w.....www..w.w.w
w.A....ww.....ww
w.....wwww.....w
wwwwwwwwwwwwwwww