wwwwwwwwwwwwwwww
w......w.......w
wA.....w.......w
w.....w........w
w...w..w.w...+.w
w...w2www.....ww
w..............w
w.2....w..w....w
w.....ww...2...w
w......w+...1..w
w......w.......w
wwwwwwwwwwwwwwww