wwwwwwwwwwwwwwww
w..g.www.ww.g..w
w..............w
w...ww.........w
w...w..1.......w
w..............w
w....ww...wwwwww
w.........w....w
w......ww......w
wA...w.w+......w
www............w
wwwwwwwwwwwwwwww