wwwwwwwwwwwwwwww
w.............gw
w....g.........w
w..w...........w
w.........wwwwww
wwwww2.........w
w....2wwwwwwwwww
w...2.....w+...w
w...2.....w....w
w.A............w
w..w...........w
wwwwwwwwwwwwwwww