wwwwwwwwwwwwwwww
ww.w...w..w...gw
w..............w
w..w.ww........w
w............+.w
w.....w........w
w.....w..wwwwwww
w.........w+...w
w......w..w....w
wA.............w
w..............w
wwwwwwwwwwwwwwww