wwwwwwwwwwwwwwww
w.....ww.ww....w
w.....ww.......w
w......2.......w
w...w..2..w..+.w
w.11..w........w
w.......wwwwww.w
w..1.......2...w
w..1.........w.w
wA..........1.ww
w..............w
wwwwwwwwwwwwwwww