wwwwwwwwwwwwwwww
w.....ww.w....gw
w.....ww.......w
w...w.ww.......w
w...w..w..w....w
w...w.ww.......w
w.....w...wwwwww
w.21...........w
w.......w....www
w..............w
w..............w
wwwwwwwwwwwwwwww