wwwwwwwwwwwwwwww
w.........w.g..w
wA.............w
w..w...........w
w..2...w.....+.w
w...w2w........w
w.....w...w..w.w
w..........+...w
w......w.....www
wA............ww
w..............w
wwwwwwwwwwwwwwww