wwwwwwwwwwwwwwww
w.....wwwww.g..w
w..............w
w..............w
w...w.....w.w+.w
www1w.w...www..w
w....ww.w......w
w..1.....w.2...w
w....w.....2...w
w.......w......w
w..1...........w
wwwwwwwwwwwwwwww