wwwwwwwwwwwwwwww
w.........w.g..w
w.....w........w
w....w.........w
w...w..w.....+.w
w..1..w........w
w....ww.ww.....w
w..........2...w
w..........2.w.w
wA.............w
w..............w
wwwwwwwwwwwwwwww