wwwwwwwwwwwwwwww
ww.w..........gw
wwww...........w
w..w.w.........w
w.........w..+.w
w....ww...www..w
w..............w
w..........2...w
w..........w.w.w
w.A............w
w..............w
wwwwwwwwwwwwwwww