wwwwwwwwwwwwwwww
w.g..w.ww.....gw
w..............w
w..w...........w
w..2w.....w.w..w
w....2......w..w
w....2....wwwwww
w..........+...w
w.........w..www
wA....2........w
w..............w
wwwwwwwwwwwwwwww