wwwwwwwwwwwwwwww
w.........w...gw
wA.............w
w.......w......w
w...w..........w
w..ww.www......w
w...........ww.w
w..............w
w......ww.w2wwww
w......w+......w
www............w
wwwwwwwwwwwwwwww