wwwwwwwwwwwwwwww
w..1......w...Aw
wA.............w
w..w.ww........w
w..2w........+ww
www.....1.wwwwww
www..2....wwwwww
w..............w
w.........w..www
w.............ww
w..............w
wwwwwwwwwwwwwwww