wwwwwwwwwwwwwwww
w.....ww.ww.1.gw
w...wwww.......w
w..............w
w...w..w.......w
w..............w
w..............w
w..............w
w.........w2..1w
w.A..w.........w
w..............w
wwwwwwwwwwwwwwww