wwwwwwwwwwwwwwww
ww.ww.......1..w
wA.............w
w..w.w.........w
w....w.........w
w..............w
w....w11..wwwwww
w.........w+...w
w.........w..w.w
wA.............w
w..............w
wwwwwwwwwwwwwwww