wwwwwwwwwwwwwwww
w.............gw
w......w.......w
w..............w
w..ww..w.ww.w+ww
wwwww2w....w..ww
ww.............w
w..........2...w
w......w...2...w
wA......+......w
w......w.......w
wwwwwwwwwwwwwwww