wwwwwwwwwwwwwwww
w.........w....w
ww...g.........w
ww.w..w.w......w
w.......wwwww+ww
w..wwww..wwww..w
w.........w....w
w.....1....+...w
w..........2.www
w....w........ww
w..............w
wwwwwwwwwwwwwwww