wwwwwwwwwwwwwwww
w.........w.g..w
w......w.......w
w......w.......w
w.w2w..w..w..+.w
w.w1w.ww.......w
w....ww...wwwwww
w..1.......+...w
w.........w..www
wA..........1.ww
w..............w
wwwwwwwwwwwwwwww