wwwwwwwwwwwwwwww
w......w..w...gw
w....g.....1...w
w..w..w.w......w
w.......w....+.w
w....2w.w......w
w.........wwwwww
w.........w+...w
w......ww.w....w
wA.............w
w..............w
wwwwwwwwwwwwwwww