wwwwwwwwwwwwwwww
w.............gw
wA.............w
w..ww..........w
w..2...w.w...+ww
w...w..w.wwwwwww
w..............w
w..............w
w..............w
w.A............w
w..............w
wwwwwwwwwwwwwwww