wwwwwwwwwwwwwwww
w....w....w...gw
w....w.........w
w....w.........w
w...w..........w
w....2.........w
ww........wwwwww
w.........w+...w
w..............w
wA............ww
w......w.......w
wwwwwwwwwwwwwwww