wwwwwwwwwwwwwwww
w.....ww..w...gw
w.....w........w
w...w.w........w
w...w.....w..+ww
www.w2w......w.w
w........wwwww.w
w...w..........w
w......w..w....w
w.A..w......A..w
w..www.w.......w
wwwwwwwwwwwwwwww