wwwwwwwwwwwwwwww
w.........w...gw
w..............w
w..w...........w
w..2...w..w....w
w....w.w.......w
w.......1..w.w.w
w..........+...w
w.........w2..ww
wA.............w
w..............w
wwwwwwwwwwwwwwww