wwwwwwwwwwwwwwww
w.....w...w....w
wA...www.......w
w.....w........w
w...w..2.....+.w
w....wwww.....ww
ww........wwwwww
w..........1...w
w......w.......w
w..............w
w......ww......w
wwwwwwwwwwwwwwww