wwwwwwwwwwwwwwww
w...........g..w
wA.............w
w....w.........w
w.w.w..2.....+.w
w.w1...........w
w....ww.w....w.w
w..........2...w
w..........w.w.w
wA....2.......ww
w..............w
wwwwwwwwwwwwwwww