wwwwwwwwwwwwwwww
w......w..w...gw
w....g.w.......w
w.....www......w
w...w..www...+.w
ww..w2www.....ww
ww.........wwwww
w..........+...w
w......w..w....w
wA.....w....1..w
w......w.......w
wwwwwwwwwwwwwwww