wwwwwwwwwwwwwwww
w.....www.w...gw
wA.............w
w..wwww2.......w
w.w.......w....w
w...........w..w
w....wwwwwwwwwww
w....w.....w...w
w....w.........w
w.A..w.........w
w..............w
wwwwwwwwwwwwwwww