wwwwwwwwwwwwwwww
w.....ww......gw
w....gw........w
w.w...w........w
w.w....w.w..wwww
w.w..wwwww.w..ww
w.....ww.w.w...w
w..........w...w
w..w..ww.......w
w..............w
w..............w
wwwwwwwwwwwwwwww