wwwwwwwwwwwwwwww
w.....w.......gw
w....g.........w
w..............w
w.w2w..w.wwwwwww
wwwww2...wwwww.w
w....2....w....w
w.2.......w....w
w......w.......w
w.A............w
w..............w
wwwwwwwwwwwwwwww