wwwwwwwwwwwwwwww
w.............Aw
wA....w........w
w..wwww........w
w............+ww
w...........w.ww
w..............w
w.........w....w
w....w.w..w.wwww
w....w..+......w
w...ww.........w
wwwwwwwwwwwwwwww