wwwwwwwwwwwwwwww
w....www..w....w
w..............w
ww..w.w........w
ww...........+.w
w.....w......w.w
ww...wwwwww.wgww
w..............w
w..w.w.ww......w
w....w.ww......w
w..............w
wwwwwwwwwwwwwwww