wwwwwwwwwwwwwwww
w......w..w....w
w....g.........w
w.....www......w
w..2w..ww.w..w.w
ww.ww2.........w
ww......wwwwwwww
w..........+...w
w..............w
w1.............w
w..............w
wwwwwwwwwwwwwwww