wwwwwwwwwwwwwwww
w......w.w..1..w
wA.....w.......w
w......w.......w
w...w..w.......w
w....www......ww
w..........wwwww
w..........2...w
w......w.......w
w2.............w
w......w.......w
wwwwwwwwwwwwwwww