wwwwwwwwwwwwwwww
w......w.......w
w....g.w.......w
w.....www......w
w..2...w.....w.w
w..ww2ww.......w
w..............w
w..........+...w
w......w...2.www
wA.....w+...1..w
w1.....w.......w
wwwwwwwwwwwwwwww