wwwwwwwwwwwwwwww
ww.............w
ww...g.........w
w..w.ww........w
w.w..........+ww
w..............w
w....wwwww.ww.ww
w..........w...w
w....ww........w
w..............w
w..w...........w
wwwwwwwwwwwwwwww