wwwwwwwwwwwwwwww
w....w....w...gw
w....ww........w
w....w.........w
w.w.w........+.w
www.w.w.....w..w
www..w....w.wg.w
w..............w
w.........w2w..w
w.A.......w....w
w..............w
wwwwwwwwwwwwwwww