wwwwwwwwwwwwwwww
w.............gw
wA.............w
w..w...........w
w..............w
w..wwwwww......w
w..............w
w..............w
w......w..w2wwww
wA.....w.......w
w......w.......w
wwwwwwwwwwwwwwww