wwwwwwwwwwwwwwww
w.........www..w
wwwg...........w
ww.www.........w
ww...........+.w
wwwww.....w....w
ww...w....w.ww.w
w.........w....w
w...2w....w.ww.w
w....w.w+.....ww
w....w.w.......w
wwwwwwwwwwwwwwww