wwwwwwwwwwwwwwww
w.....w........w
wA...gw....ww..w
w.wwwww........w
w.w.w.....w.w+ww
www.w.....wwwwww
w....wwww......w
w........w.....w
w....w.........w
w.A..w.........w
w.w............w
wwwwwwwwwwwwwwww