wwwwwwwwwwwwwwww
w....www..w.g..w
w..............w
w...ww.........w
w...w.....w..+.w
www.w..........w
ww...wwwwwwwwgww
w..........2...w
w....w....w....w
w....w.........w
w..w...........w
wwwwwwwwwwwwwwww