wwwwwwwwwwwwwwww
w.....ww..w....w
w....g.........w
w.....www......w
w..2...www...+ww
wwwwwwwwwwwww.ww
ww....w........w
w..........2...w
w..w.wwww..2...w
w...........1..w
w..............w
wwwwwwwwwwwwwwww