wwwwwwwwwwwwwwww
w......w.......w
wA.............w
w..w..w........w
w..2...w.......w
w..ww2.........w
w....2.......w.w
w..........2...w
w............w.w
w.............ww
w..............w
wwwwwwwwwwwwwwww