wwwwwwwwwwwwwwww
ww........w...gw
wA.............w
w..............w
w...w........+.w
w.....w...w....w
w..............w
w..............w
w....w....ww.www
w....w........ww
w..............w
wwwwwwwwwwwwwwww