wwwwwwwwwwwwwwww
w......w..w...gw
wA.........1...w
w..w.w.........w
w............1.w
w..............w
w....ww11wwwww.w
w..........w...w
w..............w
w....w.........w
w..............w
wwwwwwwwwwwwwwww