wwwwwwwwwwwwwwww
w.....w.......gw
w....g.........w
w...w.w........w
w.w2w....www.www
www.w2......wwww
ww...2wwwwwwwgww
w.2.......w....w
w....w....w....w
w.A............w
w..w...........w
wwwwwwwwwwwwwwww