wwwwwwwwwwwwwwww
w.............gw
w..............w
w.....w.w......w
w..2....wwwww+ww
wwwww2wwwwwwwwww
w.........w....w
w.2............w
w......w..w..www
w.A..w.w+...1..w
w...wwww.......w
wwwwwwwwwwwwwwww