wwwwwwwwwwwwwwww
w.........w...gw
wA.............w
w......w.......w
w..2w..wwww..+ww
wwwww2.ww.ww.www
w.........wwwgww
w..............w
w.............ww
w.A...........ww
w..............w
wwwwwwwwwwwwwwww