wwwwwwwwwwwwwwww
w..g...........w
w..............w
w..w.w.........w
w..2......w..+ww
w....2.ww.w...ww
w....2....w....w
w..........+...w
w.............ww
wA.............w
w......w.......w
wwwwwwwwwwwwwwww