wwwwwwwwwwwwwwww
w......w.......w
w....g.....1...w
w..w..w.w......w
w.......w....+.w
w....wwww.www.ww
w..............w
w..........+...w
w......w..w..w.w
w.A............w
w.....ww.......w
wwwwwwwwwwwwwwww