wwwwwwwwwwwwwwww
w.............gw
w....w......w..w
w..............w
w...w..w.ww..+ww
wwwww2....www.ww
w..............w
w..........2...w
w..........2...w
w..............w
w..............w
wwwwwwwwwwwwwwww