wwwwwwwwwwwwwwww
w.........w.1..w
wA.....w.......w
w......ww......w
w......w..w....w
w...wwwww.w....w
w.........w..w.w
w.2........+...w
w..........2.www
w....w.w.......w
w...ww.w.......w
wwwwwwwwwwwwwwww