wwwwwwwwwwwwwwww
w..g.www.ww.1..w
wA...ww........w
w..wwwww.......w
w..2...2..w....w
w.w...........ww
w.w......wwwwwww
w..............w
w....w.........w
w.1..w.........w
w.w.w..........w
wwwwwwwwwwwwwwww