wwwwwwwwwwwwwwww
w......w.......w
wA.............w
w..w.ww.w......w
w............+.w
w..ww2w.....w..w
w.........w.ww.w
w.........w....w
w.........w.ww.w
wA............ww
w..............w
wwwwwwwwwwwwwwww