wwwwwwwwwwwwwwww
w..1.....ww...gw
wA.............w
w..wwww.w......w
w..............w
w..ww2w........w
w.........wwwwww
w.........w....w
w...2..w..w..w.w
w1.....w+......w
w......w.......w
wwwwwwwwwwwwwwww