wwwwwwwwwwwwwwww
w..g1.ww......gw
w.....ww...1w..w
w....ww........w
w...w........+.w
ww.............w
www............w
w..............w
w......w...2.w.w
wA.....w..1.1..w
w......w.......w
wwwwwwwwwwwwwwww