wwwwwwwwwwwwwwww
w.........w...gw
wA.............w
w..............w
w..2w..w.w...+ww
www.w.....wwwwww
w.........wwwgww
w..............w
w...2.........ww
w.............ww
w..w...........w
wwwwwwwwwwwwwwww