wwwwwwwwwwwwwwww
w.............gw
wA.............w
w.ww.ww........w
w.www........+ww
www...w....ww..w
w.w.....w..w...w
w..........w...w
w.........ww.w.w
w.A...........ww
w..............w
wwwwwwwwwwwwwwww