wwwwwwwwwwwwwwww
ww............Aw
w..............w
w..ww.w.w......w
w..2....w.w..+ww
w...w.....ww..ww
w.........wwww.w
w..........w...w
w....ww......www
w.A..ww.......ww
w..............w
wwwwwwwwwwwwwwww