wwwwwwwwwwwwwwww
ww............gw
ww...g.........w
w....ww........w
w............+.w
w..............w
w.......1.wwww.w
w.........w+...w
w....w....w..w.w
w.A..w........ww
w....w.........w
wwwwwwwwwwwwwwww