wwwwwwwwwwwwwwww
w.....ww..w....w
wA....w........w
w..w..ww.......w
w......2.....www
w....wwww.....ww
w.......ww.2...w
w..........2...w
w......w...2...w
wA.............w
ww.....w.......w
wwwwwwwwwwwwwwww