wwwwwwwwwwwwwwww
w......w..w...gw
w..g...........w
w..wwwwww......w
w..2......w..www
wwwww2....wwwwww
w.........wwwgww
w..............w
w...2w....w...ww
w....w.........w
w..ww..........w
wwwwwwwwwwwwwwww