wwwwwwwwwwwwwwww
w.........w...gw
w....g.........w
w......ww......w
w.w....wwww..+ww
wwwww2wwww.....w
www.......ww.g.w
w.2........+...w
w.....ww.......w
w.A.........1..w
w......w.......w
wwwwwwwwwwwwwwww