wwwwwwwwwwwwwwww
w.....ww.......w
w....gww.......w
w..w..w........w
w.........ww.www
w...w2www.w..www
w.........wwwgww
w.2.......w....w
w......w..w...ww
w.A....w.......w
w...w.ww.......w
wwwwwwwwwwwwwwww