wwwwwwwwwwwwwwww
w.....ww.......w
w....g.........w
w.....w........w
w............+.w
ww...2w........w
ww....w.www....w
w..........+...w
w.......w.w....w
wA.............w
w..............w
wwwwwwwwwwwwwwww