wwwwwwwwwwwwwwww
w..w..........gw
wwwww.w........w
w.wwww.........w
w.w..........+.w
w.....ww..w.w..w
w..............w
w..............w
w.........w2ww.w
w.A..w.........w
w..............w
wwwwwwwwwwwwwwww