wwwwwwwwwwwwwwww
w....www.......w
w....g.........w
w..w.ww........w
w..2.........+ww
www.w2.........w
w....wwwwwwwwwww
w.........w+...w
w..w2w..w.w....w
w..............w
w..w...........w
wwwwwwwwwwwwwwww