wwwwwwwwwwwwwwww
w..1..........gw
wA....w........w
w....w.........w
w.www........1ww
w+w.w.....wwww.w
w.w......wwwww.w
w.........w....w
w....w.......w.w
w....w........ww
w..............w
wwwwwwwwwwwwwwww