wwwwwwwwwwwwwwww
w.........w...Aw
w..g.g......w..w
w..w...........w
w........wwww+ww
wwwww2w.wwwww.ww
ww......w......w
w..........2...w
w...wwwww......w
w.A............w
w..w...ww......w
wwwwwwwwwwwwwwww