wwwwwwwwwwwwwwww
w.........w...gw
w...www........w
w....w.........w
w.w.w..w..w....w
w.w..ww...www..w
w.........wwww.w
w..............w
w.........w..www
w.A..w........ww
w..............w
wwwwwwwwwwwwwwww