wwwwwwwwwwwwwwww
w.w..w....w...gw
w..............w
w..............w
w...w..w.....1.w
www.w2.........w
w....2....wwwwww
w.........w....w
w.........w..w.w
wA.............w
w..............w
wwwwwwwwwwwwwwww