wwwwwwwwwwwwwwww
w.....ww....g..w
w.w..g.w.......w
w.w............w
w.w....w.....+.w
w....ww........w
w....wwwww.w.w.w
w........w.w...w
w..............w
wA.............w
w..............w
wwwwwwwwwwwwwwww