wwwwwwwwwwwwwwww
wAw.....www....w
w........ww.3..w
w..............w
wwwwwww......w.w
w1.......w...w+w
wwwwwwwwwww..w.w
w...w..........w
wgw.......w2...w
ww..w.....ww...w
w.w.......wwwwww
wwwwwwwwwwwwwwww