wwwwwwwwwwwwwwww
w......ww......w
w..1...+w.....Aw
w...2...w......w
w.....w........w
w..............w
w..wwwwwwww.w..w
w....wwww...2..w
w....w.www.....w
w.......w.w....w
ww.g....w......w
wwwwwwwwwwwwwwww