wwwwwwwwwwwwwwww
w.w.w...w.wwwwww
ww........w....w
wgw.......w2...w
w..ww..w.......w
wwwwwwwwwww..w.w
w1...........w+w
ww.ww........w.w
w.......w.ww...w
w........ww.3..w
wA......www....w
wwwwwwwwwwwwwwww