wwwwwwwwwwwwwwww
wA......ww.....w
w.......wwww3..w
w.w.......w....w
ww.www.......w.w
w1........w..w+w
wwwww.wwwww..w.w
w...w..........w
wgw.....w.w2...w
ww.............w
w.........wwwwww
wwwwwwwwwwwwwwww