wwwwwwwwwwwwwwww
wg......w......w
ww.............w
w..w......w....w
w.......1..w.w.w
w............w+w
w......3..2..1ww
w..............w
wwww.w.w.w..w..w
w..........A...w
w.........w....w
wwwwwwwwwwwwwwww