wwwwwwwwwwwwwwww
w..............w
w..........A...w
wwww.w.w.ww.w.ww
w..............w
w......3..2..1ww
w............w+w
w.w.....1..w.w.w
w.........w....w
w..............w
wg.............w
wwwwwwwwwwwwwwww