wwwwwwwwwwwwwwww
w..g....w......w
w.......w......w
w......wwww....w
ww....www...2..w
w..wwwwwwwwwww.w
w...w.w........w
w...w.w........w
w...2...w......w
ww.1...+w.....Aw
w......ww...w..w
wwwwwwwwwwwwwwww