wwwwwwwwwwwwwwww
w.........w....w
wA..........w..w
w..w...........w
w.......w.w..+ww
www.w2....www.ww
w.........w..g.w
w.3............w
w..............w
w.....2........w
w.....w........w
wwwwwwwwwwwwwwww