wwwwwwwwwwwwwwww
wgw...ww.......w
w......w.......w
w.....w...w....w
w...w...1....w.w
w.....w......w+w
w......3..2..1ww
w............w.w
wwww.w.w.w..w..w
w..........A...w
w.............ww
wwwwwwwwwwwwwwww