wwwwwwwwwwwwwwww
w.........wwwwww
ww.....w..w....w
wgw.....w.w2w..w
w...w..........w
wwwwwwwwwww..w.w
w1....w......w+w
w.wwww.......w.w
w.........w....w
w........ww.3..w
wA......www..w.w
wwwwwwwwwwwwwwww