wwwwwwwwwwwwwwww
w..g....w.w....w
w.....w.w......w
w..w...www.....w
w....wwww...2..w
w..wwwwwwwwww..w
w..............w
w.....w..w.....w
w...2...w......w
w..1...+w.....Aw
w.......w......w
wwwwwwwwwwwwwwww