wwwwwwwwwwwwwwww
ww...w.........w
w.............Aw
ww....w.....w..w
ww+..w.....ww..w
wwwwww....2w.www
w.g..w.....w..ww
w............2.w
w..............w
w........2w....w
w..............w
wwwwwwwwwwwwwwww