wwwwwwwwwwwwwwww
w.wg....w......w
w.......w......w
w......wwww....w
w.....www...2..w
w..wwwwwwwwww..w
w.....w...w....w
w.....w........w
w...2...w......w
w..1w..+w.....Aw
w.......w......w
wwwwwwwwwwwwwwww