wwwwwwwwwwwwwwww
w....w.........w
w.............Aw
w..............w
ww+..w.....w...w
wwwwww....2w.www
wwg............w
w...........w2.w
w..............w
w.....w..2.w...w
w..............w
wwwwwwwwwwwwwwww