wwwwwwwwwwwwwwww
w......w..w....w
wA.w...w+...1w.w
w......w...2...w
w........w.....w
w...w....w.....w
w..w.wwww.www..w
w..2...www.....w
w.....www.w....w
w......w.......w
w...w.ww.w..g..w
wwwwwwwwwwwwwwww