wwwwwwwwwwwwwwww
w......w.w.....w
wA.....w+...1..w
w......w...2...w
w........w.....w
w........w.....w
w..wwwwwwwwww..w
w..2...www.....w
w.ww..www......w
w.w....w.......w
w......w....g..w
wwwwwwwwwwwwwwww