wwwwwwwwwwwwwwww
w........w..3..w
ww.1.....wg....w
w........www...w
w.2....w.......w
w........w.....w
wwwwww........ww
ww..+w.........w
w....w....w....w
w......w..w..A.w
w..............w
wwwwwwwwwwwwwwww