wwwwwwwwwwwwwwww
w..............w
w...A.....w..w.w
w..w..w.w.w.w.ww
w.w...........ww
ww1..2..3...w..w
w+w............w
www.w..1..w.w..w
w..w.w.........w
w..............w
w.............gw
wwwwwwwwwwwwwwww