wwwwwwwwwwwwwwww
w.....w.w..w...w
w..1...+w.....Aw
w...2...w....w.w
w.....w........w
w.....w..w.....w
w..wwwwwwwwww..w
w.....www...2..w
w......www.ww..w
w...w.w.w......w
w..g....w......w
wwwwwwwwwwwwwwww