wwwwwwwwwwwwwwww
w..............w
w.........w..A.w
ww...w....w....w
w...+w.........w
wwwwww.........w
w..........w...w
w.2............w
w........www...w
w..1.....wg....w
w........w..3..w
wwwwwwwwwwwwwwww