wwwwwwwwwwwwwwww
w..............w
w.....2........w
w...w.w........w
w.2............w
w..w......w..g.w
www.w2....wwwwww
w...w...w.w..+ww
w..w...w......ww
wA............ww
w.........w....w
wwwwwwwwwwwwwwww