wwwwwwwwwwwwwwww
w......w....g..w
w......w.......w
w.....w.w......w
w..1....ww.....w
w..wwwwwwwwww..w
w.......ww.....w
w.....w..w.....w
w......w...2...w
wA.....w+...1..w
w.....ww..w....w
wwwwwwwwwwwwwwww