wwwwwwwwwwwwwwww
w....w.........w
w.............Aw
w.......w...w..w
ww+w.w.....w...w
wwwwww....2w.www
w.g.ww.........w
w............2.w
w..............w
w....w...2.....w
w............w.w
wwwwwwwwwwwwwwww