wwwwwwwwwwwwwwww
w..............w
w........1.w.w.w
w..............w
ww..w...w....3.w
w.g..w.........w
wwwwww....3w.www
w.+..w.........w
w...........w..w
w..........w..Aw
w....w.........w
wwwwwwwwwwwwwwww