wwwwwwwwwwwwwwww
w....w.........w
w.............Aw
w....w......w.ww
ww+..w.....w...w
wwwwww....2..www
w.g..w...w.....w
w............2.w
w..............w
w...w.w..2.....w
w....w.........w
wwwwwwwwwwwwwwww