wwwwwwwwwwwwwwww
w......ww...g.ww
w....w.w..w....w
ww...wwww......w
w..2w..wwww....w
w..wwwwwwwwww.ww
w........w.....w
w........w.....w
w..w...w...2...w
wA.....w+...1..w
w..w...w.......w
wwwwwwwwwwwwwwww