wwwwwwwwwwwwwwww
w..............w
w.........w.wA.w
w....w.........w
w...+w....w....w
wwwwww.........w
w..............w
w.2........w...w
w........www...w
w.w1.....wg.w..w
w.w.....ww..3..w
wwwwwwwwwwwwwwww