wwwwwwwwwwwwwwww
w..........wwwww
ww........w....w
wg.....w...2...w
w...w.......w..w
wwwwwwwwwww..w.w
w2...........w+w
www.ww.......w.w
w...w.w...w....w
w........ww.3..w
wA......www....w
wwwwwwwwwwwwwwww