wwwwwwwwwwwwwwww
wg.w...........w
w..............w
www.......w....w
w......w1..w.w.w
w............w+w
w.w....1..2..1ww
w..............w
wwww.w.w.w..w..w
w..........A...w
w..............w
wwwwwwwwwwwwwwww