wwwwwwwwwwwwwwww
wA...w..www....w
w........ww.3..w
w.........w....w
wwwwww.......w.w
w1.....w...w.w+w
wwwwwwwwwww..w.w
w...w..........w
wgw.w.....w2...w
ww........w....w
w......w..wwwwww
wwwwwwwwwwwwwwww