wwwwwwwwwwwwwwww
w.......w......w
w..1...+.w..w.Aw
w...3...w..w...w
www...w.....w..w
w.....w........w
w..ww.wwwwwww..w
w.....wwww..2..w
w......www.....w
w.......w......w
w..g....w......w
wwwwwwwwwwwwwwww