wwwwwwwwwwwwwwww
w.........wwwwww
ww.w......w....w
wgw.....w.w1..ww
w...w..........w
wwwwwww.www.wwww
w1.....w.....w+w
ww.www.......w.w
w.........w....w
w........ww.3w.w
wA......www....w
wwwwwwwwwwwwwwww