wwwwwwwwwwwwwwww
w...w.........gw
w....w.........w
w....w.........w
w.w.w..1.......w
w+w........w...w
ww1..2..3..w...w
w..............w
w..w..w.w.w.wwww
w...A..........w
w....w.........w
wwwwwwwwwwwwwwww