wwwwwwwwwwwwwwww
ww...www......Aw
w..3.ww....w...w
w....w.........w
w.w.......wwwwww
w+............1w
w.w..wwwwwwwwwww
w........w.w...w
w...2w........gw
w....w...ww...ww
wwwwww.....w...w
wwwwwwwwwwwwwwww