wwwwwwwwwwwwwwww
w....w.w......Aw
w..3.ww........w
w....w.........w
w.w.......wwwwww
w+w...........1w
w.w..wwwwwwwwwww
w......w...w...w
w...2w.......wgw
w....w......w.ww
wwwwww....w...ww
wwwwwwwwwwwwwwww