wwwwwwwwwwwwwwww
w........w.w3..w
w..1.....wg...ww
w........www...w
w.2............w
w..............w
wwwwww.........w
w..w+w.......w.w
w....w....w....w
w.........w..A.w
w............w.w
wwwwwwwwwwwwwwww