wwwwwwwwwwwwwwww
w...w..w....g..w
w......w.......w
w.....www......w
ww.2...w.w.....w
w...wwwwwwwww..w
w.w......w...w.w
w....w...w.....w
w......w...2..ww
wA.....w+...1..w
w......w.....w.w
wwwwwwwwwwwwwwww