wwwwwwwwwwwwwwww
w..w..........ww
w.........w..A.w
w....w....w....w
w...+w.........w
ww.www.........w
w..............w
w.2............w
w........www...w
w..1....wwg....w
w........w..3..w
wwwwwwwwwwwwwwww