wwwwwwwwwwwwwwww
w..g....w......w
w.......w.....ww
w......www...w.w
w.....www...2..w
w..wwwwwwwwww..w
w.....w........w
w.....w...w....w
w...2...w......w
w..1...+w.....Aw
w......ww......w
wwwwwwwwwwwwwwww