wwwwwwwwwwwwwwww
w.w....w....g..w
w......w.......w
w...w.www......w
w..2...www.....w
w..wwwwwwwwww..w
ww......ww.....w
ww.......w.....w
w......w...2...w
wA.....w+...1w.w
w......w.......w
wwwwwwwwwwwwwwww