wwwwwwwwwwwwwwww
ww..w.....w.ww.w
ww.....+..w....w
ww.ww....ww....w
w..ww.....w..w.w
w....wwwwwww.1.w
w....wwww.w..w.w
w.....w.w....w.w
w..w....w.w....w
wA.3...........w
w..g...........w
wwwwwwwwwwwwwwww