wwwwwwwwwwwwwwww
w..............w
w........2.....w
w........w.....w
w............2.w
w.g..w.........w
www.ww.w..2w.www
ww+..w.....w...w
w...........w..w
w.............Aw
w.w..w.........w
wwwwwwwwwwwwwwww