wwwwwwwwwwwwwwww
w..ww..........w
w...Aw......w..w
w..w..w.w.w.wwww
w..............w
ww1..2..3......w
w+w......w.....w
w.w.w..1..www..w
w....w.........w
w...........w..w
ww.........w..gw
wwwwwwwwwwwwwwww