wwwwwwwwwwwwwwww
ww........w.w.ww
w..w..1...ww...w
w..............w
w.2............w
w.........w..g.w
www.w2....wwwwww
w.w.w.....w..+ww
w..w...........w
wA.......w.....w
w.........w....w
wwwwwwwwwwwwwwww