wwwwwwwwwwwwwwww
w..............w
w..w.....2.....w
w..w...........w
w............3.w
w.g..w.........w
wwwwwww...2w.www
ww+..w.....w...w
w...........w..w
w.............Aw
w...ww.........w
wwwwwwwwwwwwwwww