wwwwwwwwwwwwwwww
w..3..w........w
w....gw.....1..w
w...www........w
w............1.w
w..............w
w....w..w.wwwwww
w.........w+...w
w....w....w..w.w
w.Aw.w.........w
w...........w..w
wwwwwwwwwwwwwwww