wwwwwwwwwwwwwwww
w..3..w........w
w....gw.....1..w
w.w.www.......ww
w............2.w
w....w.........w
w.........wwwwww
w.......w.w+...w
w....w....ww...w
w.A..w........ww
w..............w
wwwwwwwwwwwwwwww