wwwwwwwwwwwwwwww
w.........wwwwww
ww.w......w....w
wgw.......w2...w
w...w..........w
wwwwwwwwwwww.w.w
w1........w..w+w
wwwwww.......w.w
w.w.......w....w
w........ww.3..w
wA......www....w
wwwwwwwwwwwwwwww