wwwwwwwwwwwwwwww
w......w...wg..w
w......w.......w
w.....www.w....w
ww.2...www.....w
w..wwwwww.www..w
w........w.....w
w........w...w.w
w......w...2...w
wA.....w+...1..w
w......w.......w
wwwwwwwwwwwwwwww