wwwwwwwwwwwwwwww
w..............w
w...A...w......w
w..w..w.www.wwww
w......w.......w
w.1..2..3......w
w+........w..www
w.w.w..1.......w
w....w.........w
w..............w
w.w...........gw
wwwwwwwwwwwwwwww