wwwwwwwwwwwwwwww
wg.wwwww.....w.w
wA..w..+.......w
w...2.....w....w
w..2w.....w....w
w......w.ww....w
w......w.ww..1.w
w......w..w....w
w.........w....w
w..............w
w..............w
wwwwwwwwwwwwwwww