wwwwwwwwwwwwwwww
ww.3..w..w.w.w.w
w....gw.....1..w
w...www.......ww
w....w.......2.w
w..............w
w.........wwwwww
w.........w+...w
w.........w....w
w.A..w.w.......w
w..............w
wwwwwwwwwwwwwwww