wwwwwwwwwwwwwwww
w..3.www.......w
w....gw.....1..w
w...www........w
w.......w...w2.w
w....w..w......w
w.w.......wwwwww
w.........w+...w
w....w....w....w
w.A..w.........w
w..w...ww......w
wwwwwwwwwwwwwwww