wwwwwwwwwwwwwwww
w..........w..gw
w..............w
w....w...w.....w
w.w.w.w1.......w
w+w..........w.w
ww1..2..3......w
w..............w
w..w..www.w.wwww
w...A..........w
w............w.w
wwwwwwwwwwwwwwww