wwwwwwwwwwwwwwww
w..............w
w.........w..A.w
w....w.........w
ww..+w.......w.w
wwwwww.........w
w..............w
w.2............w
w.w...w..www...w
w..1....wwg....w
ww..w...ww..3..w
wwwwwwwwwwwwwwww