wwwwwwwwwwwwwwww
w.........w..w.w
wA.3...........w
w....wwww.w....w
w.........w..w.w
w....w..w.w..g.w
w....w.wwww..1.w
w....w..w.w....w
w..w.wwww.w....w
w....w.+w.w....w
w.......w.w....w
wwwwwwwwwwwwwwww