wwwwwwwwwwwwwwww
w........w..3..w
w..1.....wg....w
w...w.....ww...w
w.2..........www
w..............w
wwwwww.........w
ww..+w.........w
w....w....w....w
w.....w...w.wA.w
w...........w..w
wwwwwwwwwwwwwwww