wwwwwwwwwwwwwwww
wwwwww........ww
w....w........ww
w...2w..w....wgw
w..........w..ww
w.w..wwwwwwwwwww
w+w..w........3w
w.w.......w.wwww
w....w.....w...w
w..3.ww........w
w....www......Aw
wwwwwwwwwwwwwwww