wwwwwwwwwwwwwwww
w.........w....w
wA.............w
w..w...........w
w...w....ww..+ww
www.w2....wwwwww
w.........w..g.w
w.2w...........w
w.w............w
w.....2...w..w.w
w...ww....w.w..w
wwwwwwwwwwwwwwww