wwwwwwwwwwwwwwww
w.w..www......Aw
w..3.ww........w
w....ww........w
w.w.......wwww.w
w+w..w......w.1w
w.w..wwwwwwww.ww
w.w........w...w
w...2w.......wgw
w....w........ww
wwwwww..w.w....w
wwwwwwwwwwwwwwww