wwwwwwwwwwwwwwww
w......w....g..w
w.....ww.......w
w...w.www......w
w.w2...www.....w
w..wwwwwwwwww..w
w........w.....w
w........ww....w
w....w.w...2w..w
wA.....w+...1..w
w...w..w.......w
wwwwwwwwwwwwwwww