wwwwwwwwwwwwwwww
wwwwww.........w
w....w........ww
w.w.2w.......wgw
w..........w...w
w.w..wwwwww.wwww
w+w...........1w
w.w.....w.wwwwww
ww...w...w.....w
w..3.ww........w
w....www......Aw
wwwwwwwwwwwwwwww