wwwwwwwwwwwwwwww
w..............w
w.....2..w.w...w
w..........w...w
w.2..w......w..w
w.........w..g.w
www.w2w...wwwwww
w...ww....w..+ww
w..w...........w
wA........w..w.w
w.....w...w....w
wwwwwwwwwwwwwwww