wwwwwwwwwwwwwwww
w.............gw
w.........w....w
w....w.........w
w.w.w..1.......w
w+w............w
ww3..2..3......w
w..............w
w..w..w.www.wwww
w...Aw.........w
w.....w........w
wwwwwwwwwwwwwwww