wwwwwwwwwwwwwwww
w....w..w....www
w.............Aw
w.........w.w..w
ww+..w.....w...w
wwwwww....2w.www
w.g............w
w............2.w
ww....w..w..w..w
w........2.....w
w..w...........w
wwwwwwwwwwwwwwww