wwwwwwwwwwwwwwww
w..............w
ww..A..........w
w..w.ww.w...wwww
ww.............w
ww1..2..3w.....w
w+w............w
w.w.w..1.......w
w.w..w.........w
w..........w...w
w.............gw
wwwwwwwwwwwwwwww