wwwwwwwwwwwwwwww
w..w...........w
w...A.....w....w
w..w..w.w.w.wwww
w..............w
ww1..2..2......w
w+w............w
w.w.w..1...ww..w
w....w......w..w
w.............ww
w.............gw
wwwwwwwwwwwwwwww