wwwwwwwwwwwwwwww
w......w....g..w
w.....ww.......w
w.....www......w
w.w1...www.....w
w..wwwwwwwwww..w
w....w.w.w.....w
w........w.....w
w......w...2...w
wA.....w+...1..w
w......ww......w
wwwwwwwwwwwwwwww