wwwwwwwwwwwwwwww
w..g...ww......w
w.......w......w
w......www....ww
w...w.www...2..w
w..ww.wwwwwwww.w
w.....w........w
w.w............w
w...2.w.w......w
w..1.w.+w.....Aw
w.......w......w
wwwwwwwwwwwwwwww