wwwwwwwwwwwwwwww
w......w.......w
w.A..w.........w
w....w....w....w
w.........w+..ww
w.........wwwwww
ww.............w
w............2.w
w...www........w
w....gw.....1..w
w.w3.w..w......w
wwwwwwwwwwwwwwww