wwwwwwwwwwwwwwww
wg...w.........w
w..............w
w.w.......w....w
w.......1w...w.w
w........w...w+w
w......3.w2..1ww
w..............w
wwwwww.w.w..w..w
w..........Aw..w
ww.............w
wwwwwwwwwwwwwwww