wwwwwwwwwwwwwwww
wwwwww.........w
w....w........ww
w...2w.......wgw
w..........w...w
w.w..wwwwwwwwwww
w+w...........1w
w.w......wwwwwww
w.w..w....w....w
w..3..w........w
w....www......Aw
wwwwwwwwwwwwwwww