wwwwwwwwwwwwwwww
w.........wwww.w
ww.........w...w
wgw.......w2...w
w...w..........w
wwwwwwwwwww.ww.w
w1...........w+w
wwwwww.......w.w
w.........w....w
w......w.ww.3..w
wA..w...www....w
wwwwwwwwwwwwwwww