wwwwwwwwwwwwwwww
w.......w......w
w..1...+w.....Aw
w...2...w......w
w.....w........w
w.....w........w
w..wwwwwwwwww..w
w....wwww...2..w
w.....wwww.....w
ww......w......w
w..g....ww.....w
wwwwwwwwwwwwwwww