wwwwwwwwwwwwwwww
w....www....w.Aw
w..3.ww.....w..w
w....w.........w
w.w...w...wwwwww
w+w...........1w
w.w..wwwwwwww.ww
w....w.....w...w
w...2w.......wgw
w....w.......www
wwwwww.........w
wwwwwwwwwwwwwwww