wwwwwwwwwwwwwwww
w.........w.w..w
w..........A...w
wwww.w...w..w..w
w..............w
w.....w3..2.w1.w
w.......w....w+w
w.......1..w.w.w
w...w..........w
w.............ww
wg.....w.......w
wwwwwwwwwwwwwwww