wwwwwwwwwwwwwwww
wg.............w
w..............w
ww..w.....w...ww
w.......1w.w.w.w
w.........w..w+w
w.w....3..2..1ww
w..............w
ww.w.w.w.w..w..w
w....w.....A...w
w..............w
wwwwwwwwwwwwwwww