wwwwwwwwwwwwwwww
wA......www....w
w........www3..w
w.........w....w
w.wwww.......w.w
w1......w....w+w
wwwwwwwwwww..w.w
w...w..........w
wg........w2.w.w
ww....w...w....w
w.........wwwwww
wwwwwwwwwwwwwwww