wwwwwwwwwwwwwwww
w..3..w..w....ww
w.w..gw.....1..w
w...www........w
w............2.w
w......w.......w
ww.........wwwww
w.........w+...w
w....w....w...ww
w.A..w.........w
w..............w
wwwwwwwwwwwwwwww