wwwwwwwwwwwwwwww
w......w....gw.w
w......w.......w
w..............w
w..2w.wwww.....w
w..wwwwwwwwww..w
w........w.....w
w........w.....w
w....w.w...2...w
wA.....w+...1..w
w......w.......w
wwwwwwwwwwwwwwww