wwwwwwwwwwwwwwww
w.........www.ww
ww........w....w
wgw.......w2ww.w
w...w........w.w
wwwwwwwwwww..w.w
w1...........w+w
wwwwww.w.....w.w
w.......w.w....w
w........ww.3..w
wA......www.w..w
wwwwwwwwwwwwwwww