wwwwwwwwwwwwwwww
wA......www....w
w........ww.3..w
w.........w....w
wwwww........w.w
w1..........ww+w
wwwwwwwwwww..w.w
w...w...w......w
wgw.......w2...w
ww........w....w
w.........wwwwww
wwwwwwwwwwwwwwww