wwwwwwwwwwwwwwww
w.w....w..w....w
wA...........w.w
w..w.....w.....w
w.........ww.+ww
wwwww2....wwwwww
w...w.....w..g.w
w.2............w
w..............w
w..w..2w.......w
w..............w
wwwwwwwwwwwwwwww