wwwwwwwwwwwwwwww
w....w.........w
w........w....Aw
ww.............w
ww+w.w.....w...w
wwwwww....1w.www
w.g..w.........w
w............2.w
w...w.w........w
w........2.....w
w..............w
wwwwwwwwwwwwwwww