wwwwwwwwwwwwwwww
w..3..w...w....w
ww...gw.....1.ww
w...www........w
w........w...2.w
w............w.w
w......w..wwwwww
w.........w+...w
w....ww..ww....w
w.A..ww........w
w......w.......w
wwwwwwwwwwwwwwww