wwwwwwwwwwwwwwww
ww.....w....w..w
wA...w.w+...1..w
w......w...2...w
w........w.....w
w..w.....w.....w
w..wwwwwwwwww..w
w..2w..www.....w
w.....www.w....w
w...w..w.......w
w......ww...g..w
wwwwwwwwwwwwwwww