wwwwwwwwwwwwwwww
w.......w......w
w..1...+w.....Aw
ww..2...w......w
w.....w........w
w.....w........w
ww.wwwwwwwwww..w
w..w..www...2.ww
w.w...www......w
w.......w......w
w..g...........w
wwwwwwwwwwwwwwww