wwwwwwwwwwwwwwww
w......ww...g..w
w......w.......w
w.....www..w...w
w..2...www.....w
w...wwwwwwwww..w
w........w...w.w
w.....w..w.....w
w......w...2...w
wA.....w+...1..w
w.....ww.......w
wwwwwwwwwwwwwwww