wwwwwwwwwwwwwwww
w..g....w......w
w.......w..w.w.w
w.......ww.....w
w.....www...2.ww
w..wwwww.wwww..w
w.....ww....w.ww
w.....w........w
w...2...w......w
w..1...+w.....Aw
w.......w......w
wwwwwwwwwwwwwwww