wwwwwwwwwwwwwwww
ww.....w.......w
wA.....w+...1..w
w......w...2.w.w
w........w..w..w
w.w......w.....w
w..wwwwwwwwwww.w
w..2...www.....w
w..w..www......w
w......w.......w
w......w....gw.w
wwwwwwwwwwwwwwww