wwwwwwwwwwwwwwww
w.w............w
w.A..w....ww...w
w....w...ww....w
ww........w+...w
w.........wwww.w
w..........w...w
w............2.w
w...wwww.......w
ww...gw.....1..w
w..3..w........w
wwwwwwwwwwwwwwww