wwwwwwwwwwwwwwww
w..w.ww........w
w.............Aw
w..w........w..w
ww+..w.w...w...w
wwwwww....2w.www
wwg..w.........w
w.....ww.....2.w
w....w..w...w..w
w........2.....w
w.....w.w......w
wwwwwwwwwwwwwwww