wwwwwwwwwwwwwwww
w..............w
w...A.w........w
w.....w.w.wwwwww
w..............w
ww1w.2..3......w
w+w............w
w.w.w..1.......w
w....w.........w
w.w....ww......w
w.......w.....gw
wwwwwwwwwwwwwwww