wwwwwwwwwwwwwwww
w...w.....w....w
wA.............w
w..ww..........w
w...w.....w..+ww
www.w2....wwwwww
w.........w..g.w
w.2............w
w...........w..w
w.....2......w.w
w..............w
wwwwwwwwwwwwwwww