wwwwwwwwwwwwwwww
w..............w
w..w..2........w
w..............w
w.2............w
w.........w.wg.w
www.w2w...wwwwww
w...w.....w..+ww
w..w...........w
wA............ww
w.........w....w
wwwwwwwwwwwwwwww