wwwwwwwwwwwwwwww
ww.............w
w.........w..A.w
w....w....w....w
w...+w.......w.w
wwww.w...ww....w
ww......w......w
ww2............w
w........www...w
w..1.....wg....w
w........w..3..w
wwwwwwwwwwwwwwww