wwwwwwwwwwwwwwww
ww.............w
w...A.....w....w
w..w..w.w.w.wwww
w.............ww
ww1..2..3...w..w
w+w.w........w.w
w.w.w..1.......w
w..............w
w.....ww.......w
ww.....w......gw
wwwwwwwwwwwwwwww