wwwwwwwwwwwwwwww
w...........w.gw
w......w.......w
w....w........ww
w.w.w..1.......w
w+w............w
ww1w.2..3......w
w..............w
w..w..w.w.w.wwww
w...A..........w
ww.............w
wwwwwwwwwwwwwwww