wwwwwwwwwwwwwwww
wA...w..w.w....w
w........ww.3..w
w.........w....w
wwwwww.......w.w
w1...........w+w
wwwwwwwwwww..w.w
w....w.....w...w
wgw.......w2...w
ww.....w..w....w
w.........wwwwww
wwwwwwwwwwwwwwww