wwwwwwwwwwwwwwww
w........w..3..w
w..1.....wg....w
w........www...w
w.2........w...w
w..w....w.w....w
www.w..w.....www
ww..+w.........w
w....w....w....w
w.........w..A.w
w..............w
wwwwwwwwwwwwwwww