wwwwwwwwwwwwwwww
w..............w
w.A..w........ww
w.w..w....w....w
w.......www+w..w
w........ww.wwww
w..............w
w............2ww
w...w.w........w
w...wgw.....1..w
w..3w.w........w
wwwwwwwwwwwwwwww