wwwwwwwwwwwwwwww
w......w...w..ww
w..2...+.....wAw
w...2...w.....ww
w.....w........w
w.....w........w
w..wwwwwwwwww..w
w.....www..w2..w
w..w...ww...w..w
w.......w......w
w..g....w....w.w
wwwwwwwwwwwwwwww