wwwwwwwwwwwwwwww
w........w..3..w
w..1.....wg....w
w........www...w
w.2.....w......w
w..........w...w
www.www....w...w
w...+w.........w
w....w....w....w
w.........w..A.w
w...........w..w
wwwwwwwwwwwwwwww