wwwwwwwwwwwwwwww
w.........w....w
wA..........w..w
w..w...........w
w...w.....w..+ww
www.w2....www.ww
w.......w.ww.g.w
w.2............w
w..w...........w
w.....2...ww...w
w..............w
wwwwwwwwwwwwwwww