wwwwwwwwwwwwwwww
w.w............w
w........2.....w
w..............w
w...w........2.w
w.g..w.........w
wwwwww....2w.www
ww+..w.....w...w
w...........w..w
w.............Aw
w.w.ww.....w...w
wwwwwwwwwwwwwwww