wwwwwwwwwwwwwwww
w..............w
w.....w..2.....w
w.w.w..........w
w.......w....2.w
w.g.ww........ww
wwwwww....3wwwww
ww+..w.....w...w
w...........w..w
w.............Aw
ww...w.........w
wwwwwwwwwwwwwwww