wwwwwwwwwwwwwwww
w..............w
w........2w....w
w..............w
w.w..........2.w
w.g..w........ww
wwwwww....2w.www
ww+..w.....w...w
w...........w..w
w........w....Aw
w....w.........w
wwwwwwwwwwwwwwww