wwwwwwwwwwwwwwww
w........wwwwwww
ww........w....w
wgw.......w2...w
w...w.......w..w
wwwwwwwwwww..w.w
w1...........w+w
wwwwww.........w
w.........w....w
w........ww.3..w
wA......www.w..w
wwwwwwwwwwwwwwww