wwwwwwwwwwwwwwww
w.........wwwwww
ww........w....w
wgw.......w2w..w
w...w..........w
wwwwwwwwwww..w.w
w1...........w+w
wwww.w..w....www
w.........w....w
w....w...ww.3..w
wA......www....w
wwwwwwwwwwwwwwww