wwwwwwwwwwwwwwww
w........w..3..w
ww.1.....wg....w
w....w...www...w
w.2............w
w..............w
wwwwww.........w
w...+ww........w
w....w....w....w
ww........w..A.w
w......w.....w.w
wwwwwwwwwwwwwwww