wwwwwwwwwwwwwwww
w.............gw
w..............w
w....w.w...w.w.w
w.www..1.......w
w+w............w
ww3..2w.1......w
w..............w
w..w..w.w.w.wwww
w..wA..........w
w..............w
wwwwwwwwwwwwwwww