wwwwwwwwwwwwwwww
w..........wwwww
ww........w....w
wg.........2..ww
w...w..........w
wwww.wwwwww..w.w
w1..........ww+w
wwwwww.w.....w.w
w.........w....w
w........ww.3..w
wA......www..w.w
wwwwwwwwwwwwwwww