wwwwwwwwwwwwwwww
wg.............w
w..............w
w....w....w....w
w.w.w...1..w.w.w
w............w+w
w.w....3..2..1ww
w..........w...w
wwwwww.w.w..w..w
ww.........A...w
w........w...w.w
wwwwwwwwwwwwwwww