wwwwwwwwwwwwwwww
wg.........w.w.w
w..........w...w
w.........ww...w
w.......1.ww.w.w
w.......w....w+w
w.....w3ww2..1ww
w..............w
wwww.w.w...ww..w
w..........A...w
ww.............w
wwwwwwwwwwwwwwww