wwwwwwwwwwwwwwww
w......w..w.g..w
w......w.w.....w
w.....www......w
w..2...www.....w
w..wwwww.wwww..w
w........w..w..w
w.......ww.....w
w......w...2...w
wA.....w+...1..w
w......w.......w
wwwwwwwwwwwwwwww