wwwwwwwwwwwwwwww
w..............w
w...Aw....w....w
w..w..w.w.w.wwww
w..............w
ww1..2.w3......w
w+w..w.........w
w.w.w..1.......w
w..w...........w
w.............ww
w.............gw
wwwwwwwwwwwwwwww