wwwwwwwwwwwwwwww
w..............w
ww....2w.......w
w.......w......w
w.2.......w....w
w.........w..g.w
www.w2w..wwwwwww
w...w.....w..+.w
w..w...........w
wA.............w
w.........w....w
wwwwwwwwwwwwwwww