wwwwwwwwwwwwwwww
wA......www....w
w...w....ww.2..w
w.....w...w....w
wwwwww.......w.w
w1........w..w+w
wwwwwwwww.w..w.w
w...w..........w
wgw.......w2...w
ww........w....w
w.........wwwwww
wwwwwwwwwwwwwwww