wwwwwwwwwwwwwwww
w....w.........w
w.............Aw
w...........w..w
ww+..w.....w...w
wwwwww.ww.2w.www
w.g..w..w......w
w............2.w
w....w.........w
w........2.....w
w..............w
wwwwwwwwwwwwwwww