wwwwwwwwwwwwwwww
w..............w
w...w....2.....w
w..w.........w.w
w............1.w
w.g..w.........w
wwwwww.w..2w.www
ww+..w.....w...w
w...........w.ww
w.............Aw
w....w.........w
wwwwwwwwwwwwwwww