wwwwwwwwwwwwwwww
w........w..3..w
w..1....wwg....w
ww.......www...w
w.2............w
w..w...........w
wwwwww.......w.w
w...+w.........w
w....w....w....w
w.........ww.A.w
w..............w
wwwwwwwwwwwwwwww