wwwwwwwwwwwwwwww
w.......w......w
w..1...+w.....Aw
w...2.........ww
w.....w........w
w.....w........w
w..w.wwwwwwwww.w
w.....www.w.2w.w
w......www.....w
w.......w.....ww
ww.g....w......w
wwwwwwwwwwwwwwww