wwwwwwwwwwwwwwww
w.........w....w
wA...........w.w
ww.w...........w
w...w..w..w..+ww
www..2..w.wwww.w
w........www.g.w
w.2......w....ww
w..............w
w.....2........w
w..............w
wwwwwwwwwwwwwwww