wwwwwwwwwwwwwwww
w....w.........w
ww....2........w
w..............w
ww2w...........w
w.........w..g.w
www..2....ww.w.w
w...w.....w..+ww
w..w..........ww
wA.............w
w.........w....w
wwwwwwwwwwwwwwww