wwwwwwwwwwwwwwww
w......w..w.gw.w
w......w.......w
w.w...ww.......w
w..2...www.....w
w..wwwwwwwwwww.w
w........w.....w
w...w..........w
w..ww..w...2...w
wA.....w+...1..w
w.w....w.......w
wwwwwwwwwwwwwwww