wwwwwwwwwwwwwwww
w..............w
ww.......2.....w
w...........w..w
w............2.w
w.g..w.........w
wwwwww....2..www
ww+..w.....w...w
w.........w.w..w
w.............Aw
w....w.........w
wwwwwwwwwwwwwwww