wwwwwwwwwwwwwwww
ww..........w..w
w.A..w.........w
w....w....w....w
ww........w+...w
w..w......wwwwww
w..............w
w............2.w
w...www.......ww
w....gw.....1..w
w..3..w........w
wwwwwwwwwwwwwwww