wwwwwwwwwwwwwwww
w...w..........w
wA.............w
w..w...........w
w...w...w.w..+.w
www.w2..w.wwwwww
w.........w..g.w
w.2....w.......w
w..............w
w.....2.w....w.w
w....w.....w..ww
wwwwwwwwwwwwwwww