wwwwwwwwwwwwwwww
w......ww...w..w
w..1...+w.....Aw
w...2...w......w
w.w...w......w.w
w.....w........w
w..wwwwwwwwww..w
w.....www...1.ww
w......www.....w
ww......w....w.w
w..g...........w
wwwwwwwwwwwwwwww