wwwwwwwwwwwwwwww
w..3..w........w
w..w.g......1.ww
w...www........w
w.w..........2.w
w..............w
w.........wwwwww
w.w.......w+...w
w....ww..www.w.w
w.A..w.........w
w.........w....w
wwwwwwwwwwwwwwww