wwwwwwwwwwwwwwww
w..............w
w...A.w........w
w...w.ww..w.wwww
w..............w
ww1..2..3......w
w+w............w
w.w.w..1w......w
w.w..w.........w
w..............w
w.......w.....gw
wwwwwwwwwwwwwwww