wwwwwwwwwwwwwwww
w..............w
w.........w..A.w
w....ww...w.w..w
w...+w.........w
wwww.w.........w
w......w.......w
w.2.w..........w
w........www...w
w..1.....wg....w
w........w.w3..w
wwwwwwwwwwwwwwww