wwwwwwwwwwwwwwww
wwwwww.w.......w
w....w........ww
w...2w.....w.wgw
w........w.w..ww
w.w..ww.wwwwwwww
w+w..ww...w...1w
w.w......wwwwwww
w....w.........w
w..3www........w
w..w.www......Aw
wwwwwwwwwwwwwwww