wwwwwwwwwwwwwwww
w..............w
w..w.........A.w
w....w....w....w
w...+w.........w
wwwwww.....w...w
w..............w
w.2..w.........w
w..w.....www...w
w..1...w.wg....w
ww.......w..3..w
wwwwwwwwwwwwwwww