wwwwwwwwwwwwwwww
w..1..w........w
w....gw.....1..w
w...www........w
w............2ww
w.....w........w
w.........wwwwww
w.....w...w+...w
ww...w....w...ww
w.A..w.......w.w
w........w.....w
wwwwwwwwwwwwwwww