wwwwwwwwwwwwwwww
w.wg....w......w
w.......w......w
w......www.....w
w.....www...2..w
w..wwwwwwwwww..w
ww....w........w
w.....w........w
w...2...w......w
w..1...+w.....Aw
w.......w......w
wwwwwwwwwwwwwwww