wwwwwwwwwwwwwwww
w..............w
w.....2........w
w..............w
w.2............w
w.........w..g.w
www.w2....w.wwww
w...w.....w..+ww
w..ww.w........w
wA.............w
w...w.....w....w
wwwwwwwwwwwwwwww