wwwwwwwwwwwwwwww
wA......www....w
w....ww..ww.3..w
w.........w....w
wwwwww.......w.w
w1........w..w+w
ww.wwwwwwwww...w
w...w........w.w
wgw.......w2...w
ww.............w
w......w...wwwww
wwwwwwwwwwwwwwww