wwwwwwwwwwwwwwww
wg.....w.......w
w..............w
w.........w....w
w.......1..w.w.w
w............w+w
w......3..2..1ww
ww..........w.ww
wwww.w.w.w..w..w
w..........A...w
w...........w..w
wwwwwwwwwwwwwwww