wwwwwwwwwwwwwwww
w......w....g..w
w..w...w.......w
w.....www..w...w
w..2...www.....w
w..wwwwwwwwww..w
w........w.....w
w........w.....w
w..........2...w
wA.....w+..w1..w
w......ww.....ww
wwwwwwwwwwwwwwww