wwwwwwwwwwwwwwww
w....w.w..wwwwww
ww.ww.....w....w
wgw.......w2...w
w...ww.....w...w
wwwwwwwwww...w.w
w1...........w+w
wwwwww..w....w.w
w.........w....w
w........ww.3..w
wA......www....w
wwwwwwwwwwwwwwww