wwwwwwwwwwwwwwww
w.............ww
w.............ww
w............www
w...w..........w
w..............w
w+.......ww....w
w...w....w..2..w
w..........2w..w
w..........A1.ww
w...........gwww
wwwwwwwwwwwwwwww