wwwwwwwwwwwwwwww
w.............ww
w.A..w.........w
w....w..w.w....w
ww........w+...w
w.........wwwwww
w.....w........w
w............2.w
w...www........w
w....gw.....1..w
ww.3..w........w
wwwwwwwwwwwwwwww