wwwwwwwwwwwwwwww
w..............w
w........2.....w
w..............w
ww.......w...2.w
w.g.ww.........w
wwwwww....2w.www
ww+..w.....w...w
w...........w..w
w.............Aw
w....w....ww...w
wwwwwwwwwwwwwwww