wwwwwwwwwwwwwwww
w..3..w..ww...ww
w..w.gw.....1..w
w...www........w
w............2.w
w..............w
w.........wwwwww
w..........+...w
w....w....w.w..w
w.A..ww........w
w..............w
wwwwwwwwwwwwwwww