wwwwwwwwwwwwwwwwwwwwwwwwwwwwwwww
w..............................w
w..............................w
w......+....................w..w
w...........wwwwwwwwwww........w
w................w.............w
w................w.............w
w................w.............w
w................w.............w
w.....wwwwwwwwwwwwwwwwww...ww..w
w..........w...................w
w...w......w...................w
w..........w....A..............w
w..........w...................w
wwwww......wwwwwwwwwwwwwww.wwwww
w..............................w
w..............................w
w..............................w
wwwwwwwwwwwwwwwwwww.w..........w
w...............w..............w
w....g..........w..............w
w..........ww..................w
w..........w...................w
wwwwwwwwwwwwwwwwwwwwwwwwwwwwwwww