wwwwwwwwwwwwwwwwwwwwwwwwwwwwwwww
w..............................w
w..............................w
w.......................+......w
w.....wwwwwwwwwwwwww...........w
w.............w................w
w.............w................w
w..............................w
w.............w................w
w.......wwwwwwwwwwwwwwwwww.....w
w...................w..........w
w...................w..........w
w..............A....w..........w
w...................w..........w
wwwwwwwwwwwwwwwwwwwww........www
w..............................w
w....w.........................w
w.............................ww
w............wwwwwwwwwwwwwwwwwww
w..............w...w...........w
w.........................g....w
w...................w..........w
w...................w..........w
wwwwwwwwwwwwwwwwwwwwwwwwwwwwwwww