wwwwwwwwwwwwwwwwwwwwwwwwwwwwwwww
w..............................w
w..............................w
w......+.......................w
w...........wwwwwwwwww.........w
w.............w................w
w................w.............w
w................w.............w
w................w.............w
w.......wwwwwwwwwwwwwwwww......w
w...................w..........w
w...................w..........w
w..........w....A..............w
w..........w....w...w..........w
wwwww......wwwwwwwwww..ww.wwwwww
w..............................w
w..............................w
w..............................w
www..wwww..w..wwwww.ww.........w
w...............w..............w
w....g.........................w
w..........w...................w
w..........w........w..........w
wwwwwwwwwwwwwwwwwwwwwwwwwwwwwwww