wwwwwwwwwwwwwwwwwwwwwwwwwwwwwwww
w..........w...................w
w..........w...................w
w....g.........................w
w...............w..............w
wwwwwwwwwwwwwwwwwww............w
w..............................w
w..............................w
w..............................w
wwwww......wwwwwwwwwwwwwwwwwwwww
w..........w...................w
w.........ww....A...w..........w
w..........w........w..........w
w..............................w
w.......w.wwwwwwwwwwwwww.w.....w
w................w.............w
w................w.............w
w................w.............w
w................w.............w
w...........wwww.ww............w
w......+.......................w
w..............................w
w..............................w
wwwwwwwwwwwwwwwwwwwwwwwwwwwwwwww