wwwwwwwwwwwwwwwwwwwwwwwwwwwwwwww
w..............................w
w................w.............w
w......+.......................w
w...........wwwwwww.ww.........w
w................ww............w
w................w.............w
w................w.............w
w................w.............w
w....wwwwwwwwwwwwwwwwwww.......w
w..........w...................w
w..........w...................w
w..........w....A..............w
w..........w...................w
w...w.......wwwwwwwwwwwwwwwwwwww
w..............................w
w..............................w
w.............w................w
wwwwwwwwwwww..wwwww............w
w..............................w
w....g.........................w
w.w........w..w.....w..........w
w..........w..w................w
wwwwwwwwwwwwwwwwwwwwwwwwwwwwwwww