wwwwwwwwwwwwwwwwwwwwwwwwwwwwwwww
w..........w...................w
w..........w...................w
w....g..........w..............w
w...............w..............w
wwwwwwwwwwwwwwwwwww............w
w..............................w
w..............................w
w..............................w
wwwww......wwwwwwwwwwwwwwwwwwwww
w..........w..................ww
w..........w....A..............w
w.w........w...................w
w..........w...................w
w.....wwwwwwwwwwwwwwwwww.......w
w................w.............w
w................w.............w
w................w.............w
w..............................w
w...........wwww.wwwwww........w
w......+.......................w
w..............................w
w..............................w
wwwwwwwwwwwwwwwwwwwwwwwwwwwwwwww