wwwwwwwwwwwwwwwwwwwwwwwwwwwwwwww
w..............................w
w..............................w
w.......................+......w
w..ww....wwwwwwwwwwwww.....w.www
w.............w................w
w..............................w
w..............................w
w.............w................w
w.......wwwwwwwwwwwwwwwwww.....w
w.......w...........w..........w
w...................w..........w
w..............A....w..........w
w...................w..........w
w.ww.wwwwwwwwwwwwwwww......wwwww
w..............................w
w..............................w
w..............................w
w............wwwwwwwwwwwwwwwwwww
w..............................w
w..............w..........g....w
w..............................w
w..............................w
wwwwwwwwwwwwwwwwwwwwwwwwwwwwwwww