wwwwwwwwwwwwwwwwwwwwwwwwwwwwwwww
w.......w..w........w..........w
w.......w..w........w..........w
w....g.........................w
w...............w..............w
wwwwwwwwwwwwwwwwww.............w
w..............................w
w..............................w
w..............................w
wwwww......wwwwwwwww.wwwwwwwwwww
w..........w...................w
w..........w....A..............w
w..........w...................w
w..........w...................w
w.......wwwwwwwwwwwwwwww.......w
w................w.............w
w................w.............w
w................w.............w
w................w.............w
w...........wwwwwwwwwww........w
w......+......w..w.............w
w..............................w
w..............................w
wwwwwwwwwwwwwwwwwwwwwwwwwwwwwwww