wwwwwwwwwwwwwwwwwwwwwwwwwwwwwwww
w..........w...................w
w..........w...................w
w....g.........................w
w...............w..............w
wwwwwwwwwwwwwwwwwww............w
w.............................ww
w..............................w
w..............................w
wwwww.w....wwwwwwwwwwwwwww.wwwww
w..........w...................w
w..........w....A..............w
w..........w...................w
w..........w...................w
w.....wwww.wwwwwwwwwwwww.......w
w................w.............w
w................w.............w
w................w.............w
w.............w..w.............w
w...........wwwwwwwwwww........w
w......+.......................w
w...................w..........w
w..............................w
wwwwwwwwwwwwwwwwwwwwwwwwwwwwwwww