wwwwwwwwwwwwwwwwwwwwwwwwwwwwwwww
w..............................w
w..............................w
w.......................+......w
w........wwwwwwwwwwwww.....w..ww
w.............w................w
w.............w................w
w.............w................w
w.............w................w
w...ww.wwwwwwwwwwwwwwwwwwww....w
w...................w..........w
w...................w..........w
w..............A....w..........w
w...................w..........w
wwwwwwwwwwwwwwwwwwwww......wwwww
w..............................w
w..............................w
w..............................w
w............wwwwwwwwwwwwwwwwwww
w..............w...............w
w.........................g....w
w...................w..........w
w...................w..........w
wwwwwwwwwwwwwwwwwwwwwwwwwwwwwwww