wwwwwwwwwwwwwwwwwwwwwwwwwwwwwwww
w..............................w
w..............................w
w......+.......................w
w.w.........wwwwwwwwwww........w
w................w.............w
w................w.............w
w................w.............w
w................w.............w
w.....wwwwwwwwwwwwwwwwww.......w
w..........w...................w
w..........w...................w
w..........w....A..............w
w..........w...................w
wwwww......wwwwwwwwwwwww..wwwwww
w..............................w
w..............................w
w..............................w
wwwwww.www.w.wwwww.............w
w............w..w..............w
w....g..........w..............w
w..........w........w..........w
w..........w..w................w
wwwwwwwwwwwwwwwwwwwwwwwwwwwwwwww