wwwwwwwwwwwww.ww
w...w.....ww.www
ww........w..w.w
wgw.......w2...w
w...w..........w
wwwwwwwwwww..w.w
w1....w......w+w
.wwwww.........w
w.........w.w..w
w....w...ww.3..w
wA...w..www....w
wwwwwwwwwwwwwwww