wwwwwwwwww.wwwww
........w.......
w..1...+w.w...Aw
w...2...w.......
w.....w...w....w
......w........w
w.wwwww.wwwww.ww
ww....ww....2..w
w..w...w.w.....w
w.......w......w
w.wg....w......w
wwwwwwwwwwwwwww.