wwwwwwwwwwwwwww.
w..g....w......w
w.......w.....ww
w.w....www.....w
w.....www...2..w
w..wwwwwwwwww..w
w.w...w........w
w.....w..w.....w
w...2w..w....w.w
w..1...+w.....Aw
w.......w......w
wwwwwwwwwwwwwwww