ww.wwwwwwwwwwwww
w..............w
w.........w..A.w
w....w....w....w
w.w.+w.........w
www.ww.......w.w
w...............
w.2....w.......w
w........www...w
w.w1.....wg....w
w........w..3..w
w.wwwwwwwwwwwwww