wwwwwwwwwwwwwwww
w..............w
w.A..w.........w
w....w....w..w.w
w.........w+...w
w.........w.wwww
w..............w
w............2.w
w...www........w
w....gw.....1..w
w..3..w.......ww
wwwwww.wwwwwwwww