wwwwwwwwwwww.www
w......w.......w
wA..w..w+...1..w
w......ww..2..ww
w.w......ww....w
w........w.w...w
w..wwwwwwwww...w
w..2...www....ww
w.....wwwwwww..w
w......w.......w
w......w....gw.w
.wwwwwwwwwwww.ww