wwwwwwww.wwwwwww
w......w....gw.w
w......w......ww
w..ww.w........w
w..2...wwww....w
w..wwwwwww.ww..w
w.....w..ww....w
w........w.....w
.......w...2...w
wA.....w+...1...
w......w.......w
wwwwwwwwwwwwwwww