wwwwwwwwwwwwwwww
w..3..w........w
w....gw.....1..w
ww..www.......ww
w....w.......2.w
w....w.........w
w.........wwwwww
w.........w+...w
w....w.w..w....w
w.Aw.w..w......w
ww.............w
wwww.wwwwwww.www