wwwwwwwwwwwwwwww
w......w.......w
.A.....w+.w.1..w
w.....ww...2...w
w........w.....w
w........w.....w
w..wwwwwwww.w..w
w..2...www.....w
w.....www......w
w......w.....w.w
w......w....g..w
wwwwwwwwww.wwwww