wwwwwwwwwwwwwwww
w..3..w........w
w....g......1..w
w...www......www
w.........w..2.w
...............w
..........wwwwww
w.........w+...w
w....w....w....w
w.A..w.........w
w.w............w
wwwwwwwwwwwwwwww