wwwwwwwwwwwwwwww
w........w..2..w
w..1.....wgw...w
w........www...w
w.2............w
w..............w
wwwwww.........w
w...+w....w....w
w....w...ww....w
w.........w..A.w
w..w...........w
wwwwwwwwwwwwwwww