wwwwwwwwwwwwwwww
w....www......Aw
w..3.ww........w
w....w.........w
w.w.......wwwwww
w+w...........1w
w.w..wwwwwwwww.w
ww......w......w
w...2w.......wgw
w....w........ww
wwwwww.........w
wwwwwwwwwwwwww.w