wwwwwwwwwwww.www
w..............w
w.A..w.........w
w....ww..w.....w
w....w....w+...w
w.....w...wwwwww
w..............w
w........w...2ww
w...www........w
w....gw.w...1..w
w..3..w...w....w
.wwwwwwwwwwwww.w