ww.wwwwww.wwwwww
w.....w.w......w
w..1...+w.....Aw
w...2...w......w
w.....w........w
w....ww........w
w..ww.wwwwwww..w
w.....www...2..w
w......www.....w
w.......w......w
w..g....w......w
wwwwwwwwwwwwwwww