wwwwwwwwwwwwwwww
w.......w..w...w
w..1w..+w..w..Aw
w.w.2...w......w
w.....w........w
w.....w........w
w..wwwwwwwwww..w
w.....www...2..w
w......www.....w
w.......w......w
w..g....w......w
wwwwwwww..wwwwww