wwww.wwwwwww.www
w....w.........w
w..........A...w
www..w.w.w..w..w
w............w.w
w...w..3..2..1ww
w............w+w
w.......1..w.w.w
w.........w....w
w....w.......w.w
wg.w...........w
wwwwwwwwwwwwwww.