wwwwwwwwwwwwwwww
w..........ww.gw
w..............w
w...ww....w....w
w.w.w.w1.......w
w+www..........w
ww1..2..3....w.w
w...........w..w
w..w..w.w.w.wwww
w...A....w...w.w
w............w.w
wwwwwwwwwwwwwwww