wwwwwwwwwwwwwww.
ww...www......Aw
w..3.ww........w
w....w...w.....w
w.ww......wwwwww
w+w....w......1w
w....wwwwwwwwwww
w..........w...w
w...2w....w..wgw
w....w........ww
www.ww......w..w
wwwwwwwwwwwww.ww