wwwwwww.wwwww.ww
w..g....w......w
w.......w......w
ww.....www..w..w
w.....www..w2...
w..wwwwwwwwww..w
w.....ww.......w
w.....w........w
w...3...w......w
w..1...+w.....Aw
........w......w
wwwwww.wwwwwwwww