wwwwwwwwwww...ww
w..........w....
w.........w..A.w
w.w..w....w....w
w...+w.........w
wwwwww.........w
w..........w...w
w.2.....w...w..w
w......w.wwww..w
w..1.....wgw...w
w........w..3..w
wwwwwwwwwwwwwwww