wwwwwwwwwwwwwwww
wA......www....w
ww.w.....ww.3..w
w.......w..w...w
wwwwww.......w.w
w1.......w...w+w
w.wwwwwwwww..w.w
w..ww..........w
wgw.......w2...w
ww........w....w
w.........www.ww
wwww.wwwwwwwwwww