wwwwwwwwwwwwwwww
w..g....w......w
w.......w......w
w......www.....w
w.....www...2..w
w..wwwwwww.ww..w
w.....w....w...w
w.....w........w
w...2...ww.....w
w..1...+w.....Aw
w.......w......w
wwwwwwwwwwwwwwww