wwwwwwwwwwwwwww.
w.........wwwwww
ww........w....w
wg........w2...w
w...w.......w..w
ww.wwwwwww...w.w
w1..........ww+w
wwwwwww.....ww.w
w.........w....w
w........ww.3..w
wA......www.w..w
ww.wwwwwwwwwwwww