wwwwwwww.wwwwwww
ww.............w
w..........A...w
wwww.w.w.w..w..w
w......w...w...w
w......3..2..1ww
w............w+w
w.......1.ww.w.w
w.........w....w
www..........www
wg..w.....w....w
wwwwwwwwwwwwwwww