wwwwwwwwwww.wwww
w.......w......w
w..1..w+w.....Aw
w...2...w.....ww
w.....w........w
w.....w.w......w
w..ww.wwwwwww..w
w...w.www...2..w
w......www.....w
w.w...w.w...w...
w.wg....w......w
wwww.wwwwwwwww.w