ww..wwwwwwwwwwww
w......w.......w
wA.....w+...1..w
w......w...2...w
w........w.....w
w....w...w......
...www.wwwwww..w
w..2...www......
w.....www......w
w......w.......w
w......w....g..w
wwwwwwwwwwwwwwww