www.wwwwwwwwwwww
.......w....g..w
w......w.......w
.......ww......w
w..2...www...w.w
w..wwwwwwwwww..w
w........w.....w
w........w......
w......w..w2...w
wA....ww+...1..w
w....w.w....w..w
ww.wwwwwwwwwwwww