.ww.wwwwwwwwwwww
w.......ww.....w
...1w..+w.....Aw
w...2...ww.....w
w.....w........w
w...w.w........w
w..wwwwwwwwww..w
w.....www...2..w
w......www......
w.......w......w
w..g....w...w..w
wwwwwwwwwwwwwwww