ww.wwwwwwwwww.ww
w.......w......w
...1...+w.....Aw
w...2...w......w
w.....w........w
w.w...w........w
w...wwwwwwwww..w
w.....www...2..w
w.....wwww.....w
w.......w...w..w
w.wgw...w....w.w
wwwwww.wwwwwwwww