www.w.wwwwwwwwww
w.....ww....g..w
.......w...w.w.w
w.....www..w...w
ww.2...www....ww
w.wwwwwwwwwww..w
w.w......w.....w
w........w.....w
w...w..w...2...w
wAw....w+.w.1..w
w......w.......w
wwwww.wwwwwwwwww