wwwwwwwwwwwwwwww
w..g....w......w
w.w.....w......w
w......www.....w
w.....www..w2..w
w..wwwwwwwwww..w
ww....w........w
ww....w..w.....w
w...2...w......w
ww.1.w.+w..w..A.
w.......w......w
wwwwwwwwwwwwwww.