.wwwwwwwwwwwwwww
w......w....g.ww
w.....ww.......w
w.....www......w
w..2....ww.....w
w..wwwww.wwww..w
w........w.w...w
w.w......w.....w
w......w...2...w
wA..w..w+...1..w
w......w.....w.w
wwwwwwwwwwwwwwww