wwwwwwwwwwwwwwww
wwwwww.........w
w....w.........w
w...2w.......wgw
w..........ww.ww
w....wwwwwwwwwww
w+w...........1w
w.w....w..wwwwww
w....w..w....w.w
w..3.ww.w......w
w....ww.......Aw
wwwwwwwwwwwwwwww