ww.wwwwwwwwwwwww
w.......w......w
w..1...+w..w..Aw
w...2...w......w
w.w...w........w
w.....w..ww.....
ww.wwwwwwwwww..w
w.....www...2..w
w......www.....w
w....w..w......w
w..g....w......w
w.wwwwwwwwwwwwww