wwwwwwwwwwwwwwww
w..3..w......w.w
w....gw..w..1..w
w...www........w
w...........w2.w
w..............w
w...w.....www.w.
w.........w+...w
w....w....ww...w
w.A..w..........
w.w...w........w
wwww.wwwwwwwwwww