wwwwwwwwwwwwwwww
w....www......Aw
w..3.w........ww
w....w.........w
..w......wwwwwww
w+w...........1w
w.w..wwwwwwwwwww
w..........w.www
w...2w.w.....wgw
w....w........ww
wwwwww.........w
w.wwwwwwwwwwwwww