wwwwwwwwwwwwwwww
w.........wwwwww
ww..w.....w....w
wgw...w.w.w2...w
w...w...w.w....w
ww.wwwwwwww..w.w
w1.w.........w+w
www.ww...w...w.w
w...w.....w....w
w........ww.3..w
wA......w.w....w
wwwww.wwwwwwwwww