.wwww.wwwwwwwwww
..........wwwwww
ww...w....w....w
wgw.......w2...w
w...w..........w
wwwwwwww.ww..w.w
w1...........w+w
wwwwww.......w.w
w.........w....w
w...w....ww.3.ww
wA......www....w
wwwwww.wwwwwwwww