wwwwwwwwwwwwwwww
w.........w...gw
w......w.w.....w
w....w.........w
wwww...1..w....w
w+w............w
ww1..2..3w.....w
w.....w........w
w..w..w.w.w.wwww
w...A.w........w
w.w.w...........
wwwwwwww.wwwwwww