ww..wwwwwwwwwwww
www3..w.......ww
w....gw.....1..w
w...www........w
ww.....w.w...2.w
w.....w........w
w.........wwwwww
w......w..w+...w
w....ww...w.ww.w
w.A..w.w.......w
w..w...........w
wwwwww.wwwwwwwww