.wwwwwwwwwwwwwww
w.............gw
w..w...........w
....ww.........w
w.w.w.w1.......w
w+w.............
ww1..2..3......w
w..............w
w..w..w.w.w.wwww
w...A..........w
w..w..........ww
.wwwwww.wwwwwwww