wwwwwwwwwwwwwwww
w...........g..w
w......w.......w
w.....www..w...w
.w.2...www.....w
w...wwwwwwwww..w
w.......ww.....w
w........w.....w
w..w...w...2...w
wA.....w+...1..w
w..............w
wwwwwwwwwwww.www