wwwwwwwwwwwwwwww
w.......w......w
...1...+w.....Aw
w...2...w......w
w..w..w...w....w
w.....w........w
w..wwwwwwwwww..w
w...w.www...2..w
w..w..wwww.....w
w...w...w......w
w..g..w.w......w
.wwwwwwww.wwwwww