wwwwwwwwwwwwwwww
w.....ww......Aw
w..3.ww........w
w....w.........w
w.w.......wwwwww
w+w...........1w
w.w..ww.www.wwww
w.w........w.w.w
w...2w.......wgw
w....w........ww
wwwwwww........w
.ww.wwwwwwwwwwww