wwwwwwwwwwwwwwww
w....www...w..Aw
...3.ww........w
w....w.........w
w.w...w...www..w
w+w...........1w
w.w..wwwwwwwwwww
w.......w..w...w
w...1w.......wgw
w....w........ww
wwwwww.........w
ww.wwwwwwwwww.ww