wwwwwwww.wwwwwww
w....www.....wAw
w..3.www.....w.w
w....w.........w
w.w.....w.w.wwww
w+w...........1w
.....www.wwwwwww
w....w.....w...w
w...2w.......wgw
w..w.w........ww
wwwwww.........w
wwwwwwwwww.wwwww