wwwwwwwwwwwwwwww
wg.........w...w
w.........w....w
w.....w...w....w
w.......1w.w.w..
w........w...w+w
w......3..2..1ww
w......w.......w
wwww.w.w...ww..w
w......w...A...w
w..............w
ww.ww.wwwwwwwwww