ww.ww.w.wwwwwwww
w.....w......w.w
w.A..w.......w.w
w....w....w....w
w.....w...w+.w.w
w........wwwwwww
w..............w
w............2.w
w...www........w
w....gww....1..w
w..3..w.........
w.wwwwwwwwwwwwww