wwwwwwwwwwwww.w.
w.............gw
w..............w
w....w.........w
w.www..1........
w+w............w
ww1..2.w3......w
w..............w
ww.w..w.w.w.wwww
w...A..........w
w..............w
w.w.wwwwwwwwwwww