wwww.wwwwwwwwwww
...3..ww.......w
w....gw.....1..w
w...www.....w..w
w.....w......2.w
w...w..w.......w
w.........www.ww
w...w.....w+...w
w....w....w....w
w.A..w...w.....w
w......w........
wwwwwwwwwwwww.ww