wwwwwwwwwwwwwwww
w........w..3..w
w..1.....wg....w
w..w.....www...w
w.2...........ww
...............w
w.wwww.........w
w...+w.........w
w....w....w....w
w.........w..A..
w...............
wwwwwwwwwwwwwwww