wwwwwwwwwwwwwww.
w.....ww......Aw
w..3.ww........w
w....w.........w
w.w.......ww.www
w+w...........1w
w.w..wwwwwww.www
w..........w...w
w...2w.......wgw
w....w........ww
wwwwww.........w
wwwwwwwwwwwwwwww