wwwwwwww.wwwwwww
...g....w......w
w.......w......w
w....w.www.....w
w.....www...2..w
w..wwww.wwwww..w
w.....w.w......w
w.....w........w
w...2..........w
w..1...+w.....Aw
w.......w......w
wwwwwwwwwwwwwwww