wwwwww..wwwwwwww
w..g....w.......
w.......w......w
w......www.....w
w......ww...2..w
w..w.w.www.ww.ww
w.....w........w
w.....w........w
w...2...w.......
w..1...+w.....Aw
w.......w......w
w.wwww.w.wwwwwww