wwwwwwwwwwwwwwww
w.......w......w
w..1...+w.....Aw
w...3...w......w
ww..........w..w
w.....w.........
w..wwwwwwwwww..w
w.....www...2..w
w......www.....w
w.......w......w
w..g....ww.....w
wwwwwwwwwwwwwwww