wwwwwwwwwwwwwwww
wA.......ww....w
w........ww.3..w
w.........ww...w
wwwwww...w...w.w
w1...........w+w
wwwwww.wwww..w.w
w.w............w
wgw.......w2...w
w.........w....w
w.........wwwwww
wwwwwwwwwwwww.ww