www.wwwwwwwwwwww
w..g..w.w......w
w.......w.w....w
w......www......
w.....www...2..w
w..wwwwwwwwww..w
w.....w........w
w.....w........w
w..w2...w......w
w..1.w.+w.....Aw
w.......w...w..w
w.wwwwwwwwwwwwww