wwwwwwwwwwwwwwww
wg.........w...w
w..............w
ww....w...w.w..w
w.......1..w...w
w............w+w
.......3w.2..1ww
...............w
wwww.w.w.w..w..w
w.w........Aw..w
w.............ww
wwwwwwwwwwwwwwww