wwwwww.wwwwwwwww
w......w.......w
wA.....w+...1..w
w......w...2...w
w........w...w.w
ww.......w.....w
w..wwwwwwwwww..w
w..2...www.....w
w.....www......w
w......w.......w
w..w...w....g..w
wwwwwwwwwwwwwww.