wwww.wwwwwwwwwww
w..g....w......w
w.......w......w
w......www.....w
w..ww.www...2..w
w..ww.wwwww..w.w
w.....w........w
w.....w.......ww
w...2w..w......w
w..1...+w..w..Aw
w.......w......w
wwwww.wwwwwwwwww