wwwwwwwwwwwwwwww
w......w....g..w
w......w.......w
w.....www......w
w..2..wwww.....w
w..wwwwwwwwww..w
w........w.....w
w........w.....w
w......w...2...w
wA....ww+...1..w
w......w.......w
ww.wwwwwwwwwwwww