wwwwwwwwwwwwwwww
w.....w.w......w
w..1...+w.w..wAw
w...2...w.w....w
w....ww........w
w.....w........w
w..wwwwwwwwww...
w.....www...2..w
ww.....wwww....w
w..w........w..w
w..gw...w......w
wwwwwwwwwwwwwwww