wwwwwwwwwwwwwwww
w..g.........w.w
w.......w......w
w.w....www.....w
w.....www.w.2..w
w..wwwwwwwwww..w
w.....w........w
w.....w........w
w...2..ww.....ww
w..1...+......Aw
w.w.....w.....ww
wwwwwwwwwwwwww.w