wwwwwwwwwwwwww.w
w..ww.w........w
wwAw.w.........w
w....w....w....w
w.........w+...w
w.........wwwwww
w..............w
w............2.w
w...www........w
w....gww..w.1w.w
w..3..w........w
wwwwwwwwwwwwwwww