wwww.wwwwwwwwwww
w..3..w........w
w....gw.....1..w
....www........w
w...w....w...2.w
w..............w
w.w......w.wwwww
w.........w+...w
w....w.w.......w
w.A..w.........w
w.w..w.........w
wwwwwwwwwwwwwwww