wwwwwwwwwwwwwwww
............w..w
w...A..........w
ww.w..w.w.w.wwww
w..............w
ww1..2..3..w...w
w+w............w
w.w.w.w1.......w
.....w.........w
w..............w
w...w.........gw
wwwwwwwwww.wwwww