wwwwwwww.wwwwwww
w.............gw
w......ww......w
w....w.....ww..w
w.w.w..1.....w.w
w+w............w
ww1..2..3..w....
w.............ww
w..w..w.w.w..www
w...A..........w
w..............w
wwwwwwwwwwwwwwww