w.wwwwwwww.ww.ww
w..w..w.w......w
w..1...+w.....A.
w...2...w......w
w...w.w...w....w
w.....ww.......w
.w.wwwwwwwwww..w
w.....www...2..w
w..w...wwww....w
w.......w......w
w..g..w.w.w....w
wwwwwwwwwwwwwwww