wwwwwwwwwwwwwwww
w..............w
w...A.......w.ww
w.ww..w.w.w.wwww
w.w............w
ww1..2..3......w
w+w............w
w.w.w..1.......w
w....w........ww
w.w............w
w.............gw
wwwwwwwwwwwwwwww