wwwwwwwwwwwwww.w
wg.w.........w.w
w..............w
w..w.......w...w
w.......1..w.w.w
w.........w..w+w
w......3..2.w1ww
w..............w
.www.w.w.w..w..w
w.w........A...w
w..............w
wwwwwwwwwwwwwwww