w.wwwwwwwwwwwwww
w......w.......w
wAw....w+...1...
w......w...2...w
w......w.w.....w
w.......ww......
w..wwwwwwwwww..w
w..2...www....ww
w.....wwww.....w
w......w.......w
w......w....g..w
wwwwwwwww.wwww.w