wwwww.wwwwwwwwww
w.....ww....g..w
w......w........
w....wwww......w
w..2...ww..w...w
w..wwwwwwwwwww.w
w.....w..w.....w
w........w.....w
w......w..w2...w
wA....ww+...1www
w......w.w.....w
wwwww.ww.wwwwwww