.wwwwww.wwwww.ww
w..........w...w
w.w.A...w......w
w..w..w.w.w.wwww
w.........w....w
ww1..2..3......w
w+w.....w......w
w.w.w..1w......w
w..w.w.........w
w..........w...w
w.........w...gw
wwwwwwww.wwwwwww