wwwwwwwwwwwwwwww
........w......w
w..1...+w.....Aw
w...2w..www....w
w..w..w......w.w
w.....ww...w...w
w..wwwwwwwwww..w
w.....www...3..w
w.w....www......
w.......w......w
w..g....ww.....w
wwwwwwwwwwwwwwww