wwwwwwwwwwwwwww.
w..g....w......w
ww..w...w......w
w......www.....w
w.....www...2..w
w..wwwwww.www..w
w.....w......w.w
w.....w........w
w...2...w.....ww
w..1...+w.....Aw
w..w....w......w
wwwwwwwwwwwww.ww