ww.wwwwwwwwwww.w
w.....w........w
w.A..w.........w
w...ww....w....w
w........ww+...w
w......w..w.w.ww
w..............w
w............2.w
w...www......w.w
w....gw..w..1..w
w..3..ww.......w
wwwwwwwwwwwwwwww