wwwwwwwwwww.wwww
w......ww......w
w..1...+w.....Aw
w...2...w......w
w.w...w.....w.ww
w.....w........w
w..wwwwwww.ww..w
w.....www...2..w
w......www.....w
w.........w....w
w..g....w.....ww
wwwwwwwwwwwwwwww