wwwwwwwwwwwwwwww
w......w....g..w
w......w.....w.w
w....ww.w......w
w..2...www.....w
w..wwww.wwww...w
w........w.....w
w........w.....w
w......w...2...w
wA.....w+...1.ww
w......w.......w
wwwwwww.ww.w.www