w.wwwwwwwwwwwwww
w......w....g..w
w......w.......w
w.....www......w
w..2...ww.w....w
w..wwwwwww.ww..w
w........w.....w
w........w.....w
w.w....w...2...w
wA...w.w+...1..w
w......w........
wwwwwwwwwwwwww.w