wwwwwwwwwwwwwwww
w.............ww
w.A..........w.w
w....w....w.....
w....w....w+...w
w.........www..w
w..............w
w............2.w
w...www.....w..w
w....gw.....1w.w
...3..w........w
wwwww...wwwww.w.