wwwwwwwwwwwwwwww
w..3..w........w
w....gw.....1..w
w...wwww.......w
w............2.w
w..w........ww.w
w.........wwwwww
w.........w+.w.w
w...ww....w....w
w.A..w.........w
w..w.........w.w
www.wwwww.wwwwww