wwwwwwwwwwwwwwww
w......w.......w
wA.....w+...1..w
w.....ww...2..ww
w.............ww
w........w...w.w
w..wwwwwwwwww..w
w..2...www.....w
ww....www.......
w......w......ww
w...........g..w
wwwwwwwwwwwwwwww