wwwwwwwwwwwwwwww
ww.g....w......w
w.......w......w
w......www......
w.....www...2..w
w.wwwwwwwwwww..w
w.w...w........w
w.w...w........w
w...2...w......w
w..1w..+w....wAw
........ww.....w
wwwwwwwwwwwwwwww