www.wwwwwwwwwwww
w........w..w.gw
w..............w
w..w.w.w.......w
www.w..1.......w
w+w.w..........w
ww1..2..3......w
w..............w
w..w..w.www..www
w...A..........w
w..............w
.w.wwwwwwwwwwwww