wwwwwwwww.wwwwww
w....www......Aw
w..3.ww........w
w....w...w.....w
w.w.......w.wwww
w+w...........1w
w.w..wwwwwwwwwww
w..........w...w
ww..2w.....w.wgw
w....ww.......ww
w.wwww.........w
wwwwwwwwwwww.www