wwwwwwwwwwww.www
wg.............w
w...wwww......ww
w.........w....w
w.......1..w.w.w
w.......w....w+w
w......3..2..3ww
w..............w
wwww.w.w.w..w..w
w.....w....A...w
w..............w
www.wwwwwwww.www