wwwwwwwwwww.wwww
w...w.w..w..3..w
w..3.....wg...ww
w..w.....www..ww
w.2w....w......w
w.w..........w.w
wwwwww.........w
w...+w.....w...w
w....w....w....w
w..w......w..A.w
w..............w
wwwwwwwwwwwwwwww