wwwwwwwwwwwwwwww
ww.g..w.w....w.w
w.....w.w......w
w......www.....w
w.....www...2..w
w..wwwwwwwwww..w
w.....w........w
w.....w...w..w.w
w...2...w......w
w..1...+w.....Aw
ww......w......w
wwwwwwwwwwwww.ww