wwwwwwwwwwwwwwww
w..g....w......w
w..w....w......w
w......w.w..w..w
w.....www...2..w
w.wwwwwwwwwww..w
w.....w..w.....w
w.....w...w....w
w...2...w......w
w..1...+w.w...Aw
w.......w......w
wwwwwwwwwwwwwwww