wwwwwwwwwwwwwwww
w....w...w.w3..w
w..1.....wg....w
w........www...w
w.2............w
w...............
wwwwww.........w
ww..+w.........w
w..www...ww....w
w.w..........A.w
w...........w..w
wwwwwwwwwwwwwwww