wwww.w.wwwwwwwww
w......w...wg...
w......w.......w
w.....www......w
w..2...www..w..w
w..wwwwwwwwww..w
w.......ww.....w
w........w...w.w
w......w...2...w
wA.....w+...1..w
w......w.......w
wwwwwwwwwwwwwwww