wwwwwww.ww.wwwww
w..g....w..ww..w
w.......w......w
w......www......
w.....www...2..w
w..wwwwwwwwww..w
w.....w..w.....w
w.....w........w
w.w.2...w......w
w..1...+w.....Aw
w.......w......w
wwwwwwwwww.wwww.