wwwwwwwwwwwwwwww
w.......w......w
w..1...+w.....Aw
w...2...w......w
w.....w...w....w
w.....w........w
w..wwwwwwwwww..w
w....wwww...2w.w
w......www......
ww......w.......
ww.g....w......w
wwwwwwwwwwwwwwww