wwwww.wwwwwwwwww
wg.........w.w.w
w..............w
w...w....ww....w
w.......1..w.w.w
w.....w......w+w
w..w...3..2..1ww
w..w...........w
ww.w.w.w.w..w..w
ww......w..A.w.w
ww............ww
wwwwwwwww.wwwwww