wwwwwwwwwwwwwwww
w......ww...g..w
w......w.......w
w.....www.w....w
ww.2...w.w.....w
w..wwwwwwwwww..w
w........w.....w
w.w..w...w.....w
w......ww..2..ww
wA.....w+...2..w
w......w.......w
wwwww.wwwwwwww.w