wwwwwwwwwwwww.ww
w......w.......w
.A.....w+...1..w
w......w...2...w
w........w.....w
w........w....ww
w..wwwwwwwwww..w
w..2..wwww.....w
w.....www......w
w......w........
w......w....g..w
wwwwwwwwwwwwwwww