ww.ww..wwwwwwwww
w......w..w.g..w
w....w.w.......w
w.....www......w
w..2...www....ww
w..wwwwwwwwww..w
ww.......w.....w
w....w...w...w.w
w......w.w.2...w
wA.....w+...1..w
w....w.w...w...w
wwwwwwwwwwwwwwww