wwwwwwwwwwwwwwww
wg.............w
w....w....w....w
w....w.w..w....w
w.......1w.w.w.w
w....w.......w+w
w..w...3.w2..1ww
w..........w..ww
wwww.w.w.w..w..w
w..........A...w
w...........w..w
wwwwwwwwwwwwwwww