wwwwwwwwwwww.www
w......w..w....w
wA.....w+.w.1..w
w......w...2...w
w......w.w.....w
w...w...ww.....w
w..ww.w.wwwww..w
ww.2...www.w...w
w.....www.ww...w
w...w..w.......w
w..w...w....g...
wwwwwwwwwwwwwwww