wwwww.wwwwwwwwww
wg.............w
w......w......ww
w.....w...w....w
w.......1.ww.w.w
w.....w......w+w
w......3..2..1ww
w..............w
wwww.w.w.w..w..w
w....w.....A...w
ww..............
wwwwww...wwwwwww