wwwwwwwwwwwwwwww
w........w.....w
w........ww..A.w
w....w....www..w
....+w...w.....w
ww.www.......w..
w...........ww.w
w.2.....w......w
.........www...w
w..1..w..wg....w
w........w.w3..w
wwwwwwwwwwwwwwww