wwwwwwwwwwwwwwww
w.........ww.www
ww..w.w...w....w
wgw.......w2...w
w...w..........w
ww.w.wwwwww....w
w1.w......w..w+w
wwwwww...w...w.w
w..w..w...w....w
w........ww.3w.w
wAw.....w.w....w
ww.wwwwwwwwwww.w