ww.wwwww.wwwwwww
w......w......ww
wAw....w+...1..w
w...w......2...w
w......w.w...www
w........w.....w
w..wwwwwwwwww..w
w..2...w.w..w..w
w.....www..w..ww
.....w.w....w..w
w......w....g..w
wwwww..wwwwwwwww