wwwwwwwwwwwwwwww
w..3...........w
w....g......1.ww
w...www........w
ww...........2.w
w..............w
w.........wwwwww
w.........w+...w
w....w....www..w
w.A..w.........w
...............w
wwwwwwwwwwwwwwww