wwwwwwwwwwwwwwww
w..............w
w..1...+w.....Aw
w...2...w....w..
......w...w....w
w.....w........w
w...www.wwwwww.w
w.....www.w.2..w
w......www.....w
w..............w
w..g....w......w
wwwwwwwwwwwwww.w