wwwww.wwwwwwwwww
w..g....w....w.w
w.......w.....ww
w......www.....w
w...w.www...2..w
w..wwww.wwwww..w
w..w..w........w
w.........w...ww
w...2...w......w
w..1...+w.....Aw
w.......w......w
wwwwwwwwwwwwwwww