wwwwwwwwwwwwwwww
wA......ww.....w
w........ww.3..w
w.........w....w
wwwwww...w...w.w
w1..........ww+w
w..wwwwww.w....w
w...w....w.w...w
wgw......ww2...w
ww...w....w..w.w
w.....w....wwww.
wwwwwwwwwwwwwww.