wwwww..wwwwwwwww
w..............w
w..........A.w.w
wwww.www.w..w...
w.............ww
w......3..1..1ww
w.w..........w+w
w......w1..w.w.w
w..............w
w..............w
wg.w...w....w..w
.wwwwwwwwwwwwwww