wwwwwwwwwwwwwwww
w.......w......w
w..1...+w.....Aw
w...2w..w......w
w..............w
w.....ww.......w
w..wwwwwwww.w..w
w.....www...2..w
w......www.....w
w....w..w....w.w
w..gw...w......w
wwwwwwwwwwwwwwww