wwwwwwww.wwwwwww
w......w.......w
wA.....w+...1..w
w......w...2...w
w........w.....w
w........w.w...w
w...wwwwwwwww..w
ww.2...www.....w
w.....www.....ww
w..w...w.....w.w
w......w....g..w
www.wwwwwwwwwwww