wwwwwwwwww.wwwww
w..3..w........w
w....gw....w1..w
w...www........w
w............2.w
w..............w
w....w....wwwwww
..........w+w..w
w....w....w....w
w.A..w.........w
ww.............w
wwwwwwww.wwwwwww