wwwww.wwwwwwwwww
w.......w......w
w..1...+w.w...Aw
w...2...w......w
w.....w........w
w...w.w........w
w..wwwwwwwwww.ww
w.....www...2..w
w.......ww.w...w
w......ww......w
w..g....w......w
.wwwwwwwwwwwwwww