wwwwwwwwwwww.www
w.w3..w.........
w....gw.....1..w
w.wwwww.w......w
.............2.w
w..............w
w.........wwwwww
w..........+...w
w....w....w....w
w.A.ww....w....w
w...........w..w
wwwwwwwwwwwwwwww