wwwwwwwwwwwwwwww
w..g....w......w
.w.....ww......w
.......w.w.....w
w.....www...2.ww
w..w.wwwwwwww..w
......w........w
w.....w........w
ww..2...w......w
.w.1...+w.....Aw
w.......w......w
www.ww.wwwwwwwww