wwww.wwwwwwwwwww
.......w......ww
wA...w.w+...1..w
w......w...2...w
w.w..w...w.....w
w........w......
w..wwwwwwwwww..w
w..2...www..w..w
w.....ww.......w
w......w.......w
w......w....g..w
wwwwwwwwwwwwwwww