wwwwwww.wwwwwwww
w...w...w.w....w
w..w......w..A.w
w....w....w.w..w
w...+w..w......w
wwwwww.........w
w..............w
w.2............w
w........www...w
w.w1.....wg...ww
w........w..3..w
wwwwwwwwwwwwww.w