wwwwwwwwwwwwwwww
w..............w
w.A..w.........w
w....w....w....w
w.........w+....
w.........ww.www
w............w.w
w............2.w
w...ww.........w
w....gw.....1..w
w..3..w........w
wwwwwwwwwwwwwwww