wwwwwwwwwwwwwww.
w..............w
w.A............w
w....w....w....w
w.........w+...w
w.........wwwwww
..............ww
w............2.w
w...www........w
.....gw.....1..w
w..3..w........w
wwwwwwwwww.wwwww