wwwwwwwww.wwwwww
w..........w.w.w
w..........A..ww
.www.w.w.w..w..w
ww.....w.......w
w......3..2..1ww
w.....w......w+w
w.......1..w.w.w
w.....w...w....w
w..............w
wg...w........ww
..wwwwwwwwwwwwww