ww.w.wwwwwwwwwww
w......w....g..w
...w...w.....w.w
w.....www......w
w..2...www.....w
w..wwwwwwwww...w
w........w.....w
w........ww....w
w.....ww..w2....
wA.....w+w..1...
w......w...w...w
wwwwwwwwwwwwwwww