wwwwwwwwwwwwwwww
w......w......w.
wA.....w+...1..w
w..w...w...2...w
ww....w..w.....w
w........w.w...w
w..wwwwwwwwww...
w..2..wwww.....w
w.....www......w
w......w.......w
w..w...w.ww.g..w
wwwwwwwwwwwwwwww