www.wwwwwwwwwwww
w.........wwwwww
ww.w......w....w
wgw..w....w2...w
w...w..........w
wwwwwww.www..w.w
w3...........w+w
wwwwww.......w.w
w.........w....w
w........ww.3..w
wA......www....w
wwwwwwwwwwwwwwww