wwwwwwwwwwwwwwww
w......w....g..w
w.....ww.......w
......www......w
w..2...ww......w
w..wwwwwwwwww..w
w....w...w....ww
w........w.....w
w......w...2...w
wA.....w+...1..w
w......w.......w
ww.wwwwww.wwwwww