wwwwwwwwwwwwwwww
w...w..w....g..w
w......w.......w
......www......w
w..2...www.....w
ww.wwwwwwwwww..w
w........w.....w
w........w.....w
w......w...2...w
wA..w..w+...1.ww
w.w....w.......w
wwwwwww.wwww.www