ww.w.w.wwwwwwwww
w.w......w..3w.w
w..1.....wg....w
w........www...w
..2.............
w...w..........w
wwwwww........ww
w...+w.....w...w
w....w....w....w
w.........w..A.w
w...w..........w
.wwwwwwwwwwwwwww