wwwwwwww.wwwwwww
ww.w...w.w..3..w
w..1......g....w
ww......wwww...w
ww2..w......w..w
w..............w
wwwwww.........w
w...+w...w.....w
w....w....w....w
w.....w...w..A.w
w..............w
wwwwwww.wwwwwwww