wwwwwwwwwwwwwwww
w..............w
w..........A...w
wwww...w.w..w..w
ww.............w
w......3..2..1ww
ww......w....w+w
w.......1..w.w.w
w.........w....w
w..............w
wg......w......w
.wwwwwwwwwwwwwww