ww.www.wwwwwwwww
wg..............
w..............w
w.........w.....
w.......1.ww.w.w
w............w+w
w...w..3..2..1ww
w..............w
wwww.w.w.ww.w..w
w..........A...w
w..............w
wwwww.wwwwwwwwww