wwwwwwwwwwwwwwww
w..............w
w...A..........w
w..w..w.w.w.wwww
w..............w
ww1..2..3......w
w+www...........
w.w.w..1.......w
w....w.........w
...............w
w.......w.....gw
www.wwwwwwwwwwww