wwwwwwwwwwwwwwww
w....w.w....g..w
w......w....w..w
w.....www......w
w..2...w.ww....w
w..wwwwwwwwww..w
w........w.....w
w...w....w.....w
.......w...2...w
.A.....w+...1..w
w...w..w.......w
wwwwwwwwww.wwwww