wwwwwwwwwwwwwwww
ww.g....w......w
w.......w......w
w......www.....w
w....wwww.w.2..w
w..wwwwwwwwww..w
w.....w......w.w
w.....w....w...w
w...2..ww......w
w..1...+w.....Aw
........w.....ww
wwwwwwwwwwwwwwww