wwwwwwwwwwwwwwww
w.......w......w
w..1.w.+w.....Aw
www.2...w......w
w.....w....w...w
w.w...w...w....w
w..wwwwwwww.w..w
w.....www.w.2...
w......www.....w
w.......w......w
w..g....w....w.w
wwwwwwwwwwwwww.w