wwwwwwwwwwwww.ww
w..g....w......w
w..ww...ww.....w
w......www.....w
ww....www...2..w
w..wwwwwwwwww..w
w...w.w........w
w.....w..w.....w
w...2...w......w
ww.1...+w.w...Aw
w.w.....w......w
wwwwwwwwwwwwwwww