wwwwww.wwwwwwwww
w.......w......w
w..1...+w.....Aw
w...2...w......w
ww....w........w
w.....w........w
w..wwwwwwwwww..w
w...w.www...2..w
w....w.www.....w
........w......w
w..g....w......w
wwwwwwwwwwwww.ww