wwwwwwwwwwwwwwww
wg.w.......w...w
w.....w.....w..w
w.w..w....w....w
w......w1..w.w.w
w.......w....w+w
w......3w.2..1ww
w..............w
wwww.w.www..w..w
w..w....w..A...w
w..............w
www.wwwwwwwwwwww