wwwww.wwwwwwwwww
w...........w..w
w...A......w...w
w..w..w...w.www.
w.w............w
ww1.w2..3......w
w+w.w..........w
w.w.w..1.....w.w
w.w..ww........w
w..............w
w.......w.w...g.
wwwwwwwwwwwwwww.