wwwwwwwwwwwwwwww
w.......w......w
w..1.w.+w..w..Aw
w...2...w.......
w.....w........w
w.....w........w
w..www.wwwwww..w
.w....www...2..w
w......www.....w
w...w...w......w
w..gw..........w
wwwwwwwwwwwwwwww