wwwwwwwwwwwwwwww
w.w.....w......w
w..1...+w.....Aw
w...2...w......w
w.....w.......ww
ww..w.w........w
w..wwwwwwwwww..w
w.....www...2.ww
w......www.....w
w..........w...w
w.wg....ww.....w
wwwwwwwwww.wwww.