wwwwww.wwwwwwwww
w.......w..w...w
w..1...+w.....Aw
ww..2...w......w
w..............w
w.....w....w...w
w..wwwwwwwwww..w
w.....wwww..2..w
w......www.....w
w.....www..w...w
w..g....w......w
wwwwwwwwwwwwwwww