www.wwwwwwwwwww.
w.........wwwwww
ww......w.w....w
wg........w2...w
w...w..w.......w
wwwwwwwwwww..w.w
w1............+w
wwwwww.w.....w.w
w.........w....w
w........ww.3..w
wA......www....w
wwwwwwwwwwwwwwww