wwwwwwwwwwwwwwww
w......w.......w
wA......+...1w.w
w......w...2...w
w........w.....w
w........w...w..
w..wwwwwwwwww..w
w..1..wwww.....w
.w....w.ww.....w
w.....www......w
w......w....g..w
.wwww.wwwwwwwwww