wwwwwwwwwwwwwwww
w...w..ww......w
w..1...+w.....Aw
w...2...w......w
w.....w....w...w
w.....w........w
w..ww.wwwwwww..w
w.....www...2..w
ww.....www.....w
w...w...w...w.ww
w..g....w......w
wwwwwwwwwwwwwwww