wwwwwwwwwwwwwwww
w......w.w.....w
.A.....w+...3..w
..w....w...2...w
w........w.....w
w........w..w..w
w..wwwwwwwwww..w
w..2...www.....w
w.....ww.......w
w......w.......w
w......w....g..w
wwwwwwwwwwwwwwww