wwww.wwwwwwww.ww
w..............w
w.A..w...w.....w
w....w....w....w
w..w......w+.w.w
w..w..w...wwwwww
w..............w
w...w........2.w
w...www...w....w
w....gw.....1..w
w..3..w........w
wwww.wwwwwwwwwww