wwwwwwwwwwwwwwww
w.w....w....g..w
w.w....w......ww
w.....www......w
w.w2...www.....w
w..wwwwwwwwww..w
w........w.....w
w........w.....w
w......w...2....
wA.....w+...1..w
w......w.......w
www.wwwwwwwwwwww