wwwwwwwwwwwwwwww
w..............w
w.........w.wA.w
w....w....w...ww
w...+w........ww
wwwwww.........w
w.............ww
w.2......w......
w........www...w
.w.1...wwwg....w
w........w..3..w
wwwwwwwwwwww.www