wwwww.wwwwwwwwww
w.........w....w
..........w..A.w
w.w.ww...ww....w
w...+w.........w
wwwwww........ww
w..w...........w
w.2............w
w........w.w...w
w..1.....wg....w
w........w..3..w
wwwwwwwwwwwwwwww