wwwwwwwwwwww.www
w........w..3..w
w..1..w..wg....w
w........www...w
w.2....w.......w
w..............w
w.wwww......w..w
w...+w....w....w
w....w....w....w
w............A.w
w..........w...w
.w.wwwwww.wwwwww