w.www.www.w.wwww
w.......ww..3..w
w..1w....wg....w
w........www...w
w.2............w
ww.............w
wwwwww..........
ww..+ww........w
w....w....w....w
w.........w..A.w
w..............w
www.wwwwwwwwwwww