wwwwwwwwwww.wwww
w......w.......w
wA......+...1..w
w......w...2..ww
w.w......w.....w
w........w.....w
w..wwwwww.www..w
w..2...w.w.....w
w.....www......w
ww.....ww......w
w......w...wg..w
w.wwwwww.wwwwwww