wwwwwwwwwwwwwwww
wg.......w.....w
w..............w
w.w.....ww.....w
w.......1..w.w.w
w........w.w.w+w
.......3..2..1ww
w...w...........
wwwwww.w.ww.w..w
w..........A...w
w..............w
wwwwwwwwwwwwwwww