wwwwwwwwwwww.www
w....www......Aw
w..3.ww...w...ww
w....w..w...w..w
w.w.....w.wwwwww
w+w...........1w
..w..wwwwwwwwwww
w..........w...w
w...2w...w...wgw
w....w........ww
w.wwww.........w
wwwwwwwwwwwwwwww