wwwwwwwwwwwwwwww
w.........wwwww.
ww........w....w
wgw.......w2...w
w..............w
wwwwwwwwwww..w.w
w1.w.........w+w
wwwwww.......w.w
w.........w....w
w......w.ww.3..w
wA......www....w
.wwww.wwwwwwwwww