wwwwwwwwwwwwwwww
w........w..3..w
w..1.....wg..w.w
..........ww...w
w.2.....w......w
w.........w....w
w.wwww.........w
w..w+w......w..w
w....w....w....w
w.........w..A.w
w..............w
wwwwwwwwwwwwwwww