wwwwwwwwwwwwwwww
w.......w...w..w
w..1.w.+ww....Aw
w...2...w......w
w.....w........w
w.....w........w
w..wwwwwwwwww...
w.....www...2..w
w......www....w.
ww......w......w
w..g..www......w
wwwwww.wwwwwwwww