.wwwwwwwwwwwwwww
w..............w
w..........A...w
www..w.w.w..w..w
w..............w
w.w....3.w2..1ww
w............w+w
w.......1..w.w..
w.......w.w....w
w...........w..w
.g.............w
wwwwwwwww.ww.www