ww.wwwwww.wwwwww
ww.g.w..w......w
w.......w......w
w......ww......w
w....wwww...2..w
w..wwwwwwwwww..w
w.....w.....w..w
w.....w........w
w...2...w......w
w..1...+w.....Aw
w.......w......w
wwwwwwwwwwwwwww.